Localidades;Periodos;EmpregosFormais ;EmpregosFormaisdeHomens ;EmpregosFormaisdeMulheres ;Cód. IBGE
Adamantina;2013;8936;4646;4290;3500105
Adamantina;2014;9312;4756;4556;3500105
Adamantina;2015;9477;4866;4611;3500105
Adamantina;2016;9716;5034;4682;3500105
Adamantina;2017;10194;5331;4863;3500105
Adolfo;2013;816;490;326;3500204
Adolfo;2014;870;493;377;3500204
Adolfo;2015;815;477;338;3500204
Adolfo;2016;835;483;352;3500204
Adolfo;2017;858;499;359;3500204
Aguaí;2013;6289;3947;2342;3500303
Aguaí;2014;6612;4140;2472;3500303
Aguaí;2015;7726;4889;2837;3500303
Aguaí;2016;6576;4121;2455;3500303
Aguaí;2017;6966;4357;2609;3500303
Águas da Prata;2013;956;586;370;3500402
Águas da Prata;2014;959;579;380;3500402
Águas da Prata;2015;995;566;429;3500402
Águas da Prata;2016;962;546;416;3500402
Águas da Prata;2017;994;544;450;3500402
Águas de Lindóia;2013;4663;2498;2165;3500501
Águas de Lindóia;2014;4802;2565;2237;3500501
Águas de Lindóia;2015;5019;2700;2319;3500501
Águas de Lindóia;2016;4690;2455;2235;3500501
Águas de Lindóia;2017;4712;2601;2111;3500501
Águas de Santa Bárbara;2013;1287;765;522;3500550
Águas de Santa Bárbara;2014;1534;959;575;3500550
Águas de Santa Bárbara;2015;1654;1040;614;3500550
Águas de Santa Bárbara;2016;1400;885;515;3500550
Águas de Santa Bárbara;2017;1387;891;496;3500550
Águas de São Pedro;2013;1366;679;687;3500600
Águas de São Pedro;2014;1462;714;748;3500600
Águas de São Pedro;2015;1268;590;678;3500600
Águas de São Pedro;2016;1346;658;688;3500600
Águas de São Pedro;2017;1429;688;741;3500600
Agudos;2013;8660;5110;3550;3500709
Agudos;2014;8305;4916;3389;3500709
Agudos;2015;8642;4987;3655;3500709
Agudos;2016;8461;4879;3582;3500709
Agudos;2017;8545;4916;3629;3500709
Alambari;2013;822;444;378;3500758
Alambari;2014;871;456;415;3500758
Alambari;2015;862;458;404;3500758
Alambari;2016;904;502;402;3500758
Alambari;2017;968;525;443;3500758
Alfredo Marcondes;2013;829;544;285;3500808
Alfredo Marcondes;2014;815;522;293;3500808
Alfredo Marcondes;2015;786;499;287;3500808
Alfredo Marcondes;2016;800;476;324;3500808
Alfredo Marcondes;2017;906;542;364;3500808
Altair;2013;688;500;188;3500907
Altair;2014;688;481;207;3500907
Altair;2015;638;451;187;3500907
Altair;2016;654;471;183;3500907
Altair;2017;704;519;185;3500907
Altinópolis;2013;3856;2526;1330;3501004
Altinópolis;2014;3789;2446;1343;3501004
Altinópolis;2015;4043;2689;1354;3501004
Altinópolis;2016;4036;2703;1333;3501004
Altinópolis;2017;4048;2685;1363;3501004
Alto Alegre;2013;716;357;359;3501103
Alto Alegre;2014;751;349;402;3501103
Alto Alegre;2015;543;322;221;3501103
Alto Alegre;2016;541;307;234;3501103
Alto Alegre;2017;532;295;237;3501103
Alumínio;2013;7123;5741;1382;3501152
Alumínio;2014;6893;5479;1414;3501152
Alumínio;2015;6479;5132;1347;3501152
Alumínio;2016;6427;5121;1306;3501152
Alumínio;2017;6305;5038;1267;3501152
Álvares Florence;2013;901;616;285;3501202
Álvares Florence;2014;672;370;302;3501202
Álvares Florence;2015;651;344;307;3501202
Álvares Florence;2016;618;321;297;3501202
Álvares Florence;2017;507;250;257;3501202
Álvares Machado;2013;3305;1877;1428;3501301
Álvares Machado;2014;3413;1924;1489;3501301
Álvares Machado;2015;3580;1949;1631;3501301
Álvares Machado;2016;3483;1967;1516;3501301
Álvares Machado;2017;3375;2039;1336;3501301
Álvaro de Carvalho;2013;359;188;171;3501400
Álvaro de Carvalho;2014;433;218;215;3501400
Álvaro de Carvalho;2015;418;227;191;3501400
Álvaro de Carvalho;2016;381;212;169;3501400
Álvaro de Carvalho;2017;400;213;187;3501400
Alvinlândia;2013;374;231;143;3501509
Alvinlândia;2014;370;227;143;3501509
Alvinlândia;2015;333;199;134;3501509
Alvinlândia;2016;363;215;148;3501509
Alvinlândia;2017;349;218;131;3501509
Americana;2013;82334;45365;36969;3501608
Americana;2014;80758;44905;35853;3501608
Americana;2015;76611;42111;34500;3501608
Americana;2016;72890;40196;32694;3501608
Americana;2017;71840;39751;32089;3501608
Américo Brasiliense;2013;8837;6391;2446;3501707
Américo Brasiliense;2014;8693;6182;2511;3501707
Américo Brasiliense;2015;8601;6050;2551;3501707
Américo Brasiliense;2016;8582;6032;2550;3501707
Américo Brasiliense;2017;9443;6370;3073;3501707
Américo de Campos;2013;502;276;226;3501806
Américo de Campos;2014;613;298;315;3501806
Américo de Campos;2015;607;287;320;3501806
Américo de Campos;2016;574;271;303;3501806
Américo de Campos;2017;568;258;310;3501806
Amparo;2013;25587;14507;11080;3501905
Amparo;2014;25896;14798;11098;3501905
Amparo;2015;24998;14078;10920;3501905
Amparo;2016;24374;13415;10959;3501905
Amparo;2017;24510;13545;10965;3501905
Analândia;2013;1020;658;362;3502002
Analândia;2014;998;645;353;3502002
Analândia;2015;1039;684;355;3502002
Analândia;2016;981;651;330;3502002
Analândia;2017;984;649;335;3502002
Andradina;2013;14444;8118;6326;3502101
Andradina;2014;14653;8227;6426;3502101
Andradina;2015;15149;8940;6209;3502101
Andradina;2016;14667;8527;6140;3502101
Andradina;2017;14775;8589;6186;3502101
Angatuba;2013;4917;3055;1862;3502200
Angatuba;2014;5200;3198;2002;3502200
Angatuba;2015;5729;3567;2162;3502200
Angatuba;2016;5030;3115;1915;3502200
Angatuba;2017;5166;3220;1946;3502200
Anhembi;2013;962;665;297;3502309
Anhembi;2014;888;592;296;3502309
Anhembi;2015;857;580;277;3502309
Anhembi;2016;788;521;267;3502309
Anhembi;2017;872;577;295;3502309
Anhumas;2013;520;281;239;3502408
Anhumas;2014;702;383;319;3502408
Anhumas;2015;568;294;274;3502408
Anhumas;2016;506;256;250;3502408
Anhumas;2017;501;233;268;3502408
Aparecida;2013;10456;5715;4741;3502507
Aparecida;2014;11145;5933;5212;3502507
Aparecida;2015;11747;6139;5608;3502507
Aparecida;2016;11750;6045;5705;3502507
Aparecida;2017;11528;5889;5639;3502507
Aparecida d'Oeste;2013;623;374;249;3502606
Aparecida d'Oeste;2014;632;383;249;3502606
Aparecida d'Oeste;2015;613;366;247;3502606
Aparecida d'Oeste;2016;612;374;238;3502606
Aparecida d'Oeste;2017;635;397;238;3502606
Apiaí;2013;5202;3017;2185;3502705
Apiaí;2014;5214;2936;2278;3502705
Apiaí;2015;5155;2916;2239;3502705
Apiaí;2016;4670;2658;2012;3502705
Apiaí;2017;4879;3090;1789;3502705
Aramina;2013;673;336;337;3503000
Aramina;2014;650;324;326;3503000
Aramina;2015;709;349;360;3503000
Aramina;2016;722;346;376;3503000
Aramina;2017;776;356;420;3503000
Arandu;2013;1358;866;492;3503109
Arandu;2014;1320;834;486;3503109
Arandu;2015;1523;974;549;3503109
Arandu;2016;1254;761;493;3503109
Arandu;2017;1328;886;442;3503109
Arapeí;2013;391;232;159;3503158
Arapeí;2014;396;232;164;3503158
Arapeí;2015;411;241;170;3503158
Arapeí;2016;373;220;153;3503158
Arapeí;2017;354;214;140;3503158
Araraquara;2013;75373;40676;34697;3503208
Araraquara;2014;77332;40451;36881;3503208
Araraquara;2015;75143;39011;36132;3503208
Araraquara;2016;74035;37259;36776;3503208
Araraquara;2017;72525;37000;35525;3503208
Araras;2013;38735;23806;14929;3503307
Araras;2014;38913;23722;15191;3503307
Araras;2015;37880;22885;14995;3503307
Araras;2016;36392;21790;14602;3503307
Araras;2017;37364;22371;14993;3503307
Araçariguama;2013;8196;5545;2651;3502754
Araçariguama;2014;8631;5728;2903;3502754
Araçariguama;2015;9301;6333;2968;3502754
Araçariguama;2016;9394;6433;2961;3502754
Araçariguama;2017;9622;6568;3054;3502754
Araçatuba;2013;54834;31924;22910;3502804
Araçatuba;2014;57103;32689;24414;3502804
Araçatuba;2015;55507;31636;23871;3502804
Araçatuba;2016;54027;30839;23188;3502804
Araçatuba;2017;53599;30604;22995;3502804
Araçoiaba da Serra;2013;5041;2993;2048;3502903
Araçoiaba da Serra;2014;5041;2853;2188;3502903
Araçoiaba da Serra;2015;5124;2864;2260;3502903
Araçoiaba da Serra;2016;4680;2560;2120;3502903
Araçoiaba da Serra;2017;4916;2640;2276;3502903
Arco-Íris;2013;286;172;114;3503356
Arco-Íris;2014;301;176;125;3503356
Arco-Íris;2015;278;167;111;3503356
Arco-Íris;2016;312;190;122;3503356
Arco-Íris;2017;308;188;120;3503356
Arealva;2013;1556;919;637;3503406
Arealva;2014;2098;1406;692;3503406
Arealva;2015;1306;782;524;3503406
Arealva;2016;1335;803;532;3503406
Arealva;2017;2082;1448;634;3503406
Areias;2013;504;327;177;3503505
Areias;2014;512;342;170;3503505
Areias;2015;544;357;187;3503505
Areias;2016;541;355;186;3503505
Areias;2017;556;367;189;3503505
Areiópolis;2013;1400;697;703;3503604
Areiópolis;2014;1199;555;644;3503604
Areiópolis;2015;1147;572;575;3503604
Areiópolis;2016;1094;516;578;3503604
Areiópolis;2017;1017;483;534;3503604
Ariranha;2013;4478;3535;943;3503703
Ariranha;2014;4067;3232;835;3503703
Ariranha;2015;4094;3147;947;3503703
Ariranha;2016;3977;3164;813;3503703
Ariranha;2017;3902;3113;789;3503703
Artur Nogueira;2013;11039;5140;5899;3503802
Artur Nogueira;2014;10619;5086;5533;3503802
Artur Nogueira;2015;11558;5338;6220;3503802
Artur Nogueira;2016;9405;4503;4902;3503802
Artur Nogueira;2017;10857;5053;5804;3503802
Arujá;2013;21729;13891;7838;3503901
Arujá;2014;23334;14744;8590;3503901
Arujá;2015;22783;14189;8594;3503901
Arujá;2016;22207;13671;8536;3503901
Arujá;2017;22354;13927;8427;3503901
Aspásia;2013;240;133;107;3503950
Aspásia;2014;243;130;113;3503950
Aspásia;2015;236;122;114;3503950
Aspásia;2016;217;115;102;3503950
Aspásia;2017;228;108;120;3503950
Assis;2013;23781;13856;9925;3504008
Assis;2014;24596;14211;10385;3504008
Assis;2015;23560;13296;10264;3504008
Assis;2016;21579;12008;9571;3504008
Assis;2017;21222;11662;9560;3504008
Atibaia;2013;39206;21902;17304;3504107
Atibaia;2014;39990;22402;17588;3504107
Atibaia;2015;39857;21775;18082;3504107
Atibaia;2016;38871;20983;17888;3504107
Atibaia;2017;39106;20891;18215;3504107
Auriflama;2013;3340;1486;1854;3504206
Auriflama;2014;3296;1475;1821;3504206
Auriflama;2015;3088;1403;1685;3504206
Auriflama;2016;2854;1247;1607;3504206
Auriflama;2017;2680;1188;1492;3504206
Avaí;2013;1636;738;898;3504305
Avaí;2014;1462;674;788;3504305
Avaí;2015;1094;654;440;3504305
Avaí;2016;963;542;421;3504305
Avaí;2017;1160;662;498;3504305
Avanhandava;2013;1941;1311;630;3504404
Avanhandava;2014;1810;1175;635;3504404
Avanhandava;2015;1949;1294;655;3504404
Avanhandava;2016;1954;1325;629;3504404
Avanhandava;2017;1955;1328;627;3504404
Avaré;2013;21392;11334;10058;3504503
Avaré;2014;21386;11401;9985;3504503
Avaré;2015;22237;11778;10459;3504503
Avaré;2016;21455;11087;10368;3504503
Avaré;2017;21947;11609;10338;3504503
Bady Bassitt;2013;3509;2298;1211;3504602
Bady Bassitt;2014;3589;2394;1195;3504602
Bady Bassitt;2015;3427;2143;1284;3504602
Bady Bassitt;2016;2979;1853;1126;3504602
Bady Bassitt;2017;2763;1596;1167;3504602
Balbinos;2013;386;179;207;3504701
Balbinos;2014;433;203;230;3504701
Balbinos;2015;422;196;226;3504701
Balbinos;2016;400;183;217;3504701
Balbinos;2017;389;183;206;3504701
Bálsamo;2013;1562;1124;438;3504800
Bálsamo;2014;1461;1007;454;3504800
Bálsamo;2015;1426;963;463;3504800
Bálsamo;2016;1301;885;416;3504800
Bálsamo;2017;1415;997;418;3504800
Bananal;2013;1890;1294;596;3504909
Bananal;2014;2024;1429;595;3504909
Bananal;2015;2136;1552;584;3504909
Bananal;2016;1930;1377;553;3504909
Bananal;2017;1843;1219;624;3504909
Barão de Antonina;2013;512;260;252;3505005
Barão de Antonina;2014;569;301;268;3505005
Barão de Antonina;2015;530;282;248;3505005
Barão de Antonina;2016;592;303;289;3505005
Barão de Antonina;2017;558;286;272;3505005
Barbosa;2013;929;445;484;3505104
Barbosa;2014;998;465;533;3505104
Barbosa;2015;785;383;402;3505104
Barbosa;2016;732;359;373;3505104
Barbosa;2017;621;286;335;3505104
Bariri;2013;9105;5788;3317;3505203
Bariri;2014;9288;5904;3384;3505203
Bariri;2015;8856;5641;3215;3505203
Bariri;2016;8973;5595;3378;3505203
Bariri;2017;9198;5693;3505;3505203
Barra Bonita;2013;13339;8723;4616;3505302
Barra Bonita;2014;12855;8362;4493;3505302
Barra Bonita;2015;12105;7953;4152;3505302
Barra Bonita;2016;11418;7465;3953;3505302
Barra Bonita;2017;11595;7796;3799;3505302
Barra do Chapéu;2013;641;398;243;3505351
Barra do Chapéu;2014;631;405;226;3505351
Barra do Chapéu;2015;557;361;196;3505351
Barra do Chapéu;2016;580;372;208;3505351
Barra do Chapéu;2017;676;428;248;3505351
Barra do Turvo;2013;692;346;346;3505401
Barra do Turvo;2014;652;317;335;3505401
Barra do Turvo;2015;632;319;313;3505401
Barra do Turvo;2016;618;303;315;3505401
Barra do Turvo;2017;646;313;333;3505401
Barretos;2013;32975;18103;14872;3505500
Barretos;2014;33896;18349;15547;3505500
Barretos;2015;34593;19143;15450;3505500
Barretos;2016;33627;18666;14961;3505500
Barretos;2017;31634;17136;14498;3505500
Barrinha;2013;3972;2400;1572;3505609
Barrinha;2014;3815;2263;1552;3505609
Barrinha;2015;3886;2354;1532;3505609
Barrinha;2016;3765;2304;1461;3505609
Barrinha;2017;3735;2250;1485;3505609
Barueri;2013;258584;140026;118558;3505708
Barueri;2014;262968;140542;122426;3505708
Barueri;2015;263246;140989;122257;3505708
Barueri;2016;254677;132244;122433;3505708
Barueri;2017;251834;133540;118294;3505708
Bastos;2013;6645;3776;2869;3505807
Bastos;2014;6639;3807;2832;3505807
Bastos;2015;7666;4493;3173;3505807
Bastos;2016;6870;3954;2916;3505807
Bastos;2017;7173;4144;3029;3505807
Batatais;2013;17043;10530;6513;3505906
Batatais;2014;16760;10333;6427;3505906
Batatais;2015;15535;9219;6316;3505906
Batatais;2016;15223;9042;6181;3505906
Batatais;2017;15683;9366;6317;3505906
Bauru;2013;129238;74181;55057;3506003
Bauru;2014;130805;74694;56111;3506003
Bauru;2015;125753;71044;54709;3506003
Bauru;2016;120854;68643;52211;3506003
Bauru;2017;121528;69414;52114;3506003
Bebedouro;2013;24496;15141;9355;3506102
Bebedouro;2014;27038;16445;10593;3506102
Bebedouro;2015;27938;17341;10597;3506102
Bebedouro;2016;24479;14891;9588;3506102
Bebedouro;2017;28549;18075;10474;3506102
Bento de Abreu;2013;816;580;236;3506201
Bento de Abreu;2014;820;611;209;3506201
Bento de Abreu;2015;925;673;252;3506201
Bento de Abreu;2016;842;622;220;3506201
Bento de Abreu;2017;919;694;225;3506201
Bernardino de Campos;2013;2295;1312;983;3506300
Bernardino de Campos;2014;2386;1313;1073;3506300
Bernardino de Campos;2015;2306;1240;1066;3506300
Bernardino de Campos;2016;2023;1157;866;3506300
Bernardino de Campos;2017;2100;1191;909;3506300
Bertioga;2013;12769;8043;4726;3506359
Bertioga;2014;12320;7629;4691;3506359
Bertioga;2015;12660;7891;4769;3506359
Bertioga;2016;12398;7671;4727;3506359
Bertioga;2017;12785;7875;4910;3506359
Bilac;2013;1563;939;624;3506409
Bilac;2014;1560;953;607;3506409
Bilac;2015;1587;1008;579;3506409
Bilac;2016;1478;930;548;3506409
Bilac;2017;1414;912;502;3506409
Birigui;2013;37893;18871;19022;3506508
Birigui;2014;37584;18599;18985;3506508
Birigui;2015;34076;16988;17088;3506508
Birigui;2016;33522;16892;16630;3506508
Birigui;2017;33181;16606;16575;3506508
Biritiba-Mirim;2013;4080;2289;1791;3506607
Biritiba-Mirim;2014;3935;2112;1823;3506607
Biritiba-Mirim;2015;3930;2085;1845;3506607
Biritiba-Mirim;2016;3873;2081;1792;3506607
Biritiba-Mirim;2017;3985;2165;1820;3506607
Boa Esperança do Sul;2013;5298;3510;1788;3506706
Boa Esperança do Sul;2014;4959;3203;1756;3506706
Boa Esperança do Sul;2015;5006;3247;1759;3506706
Boa Esperança do Sul;2016;4665;3096;1569;3506706
Boa Esperança do Sul;2017;2745;1664;1081;3506706
Bocaina;2013;4346;2877;1469;3506805
Bocaina;2014;3538;2233;1305;3506805
Bocaina;2015;3156;2047;1109;3506805
Bocaina;2016;3224;2182;1042;3506805
Bocaina;2017;2196;1218;978;3506805
Bofete;2013;1653;1000;653;3506904
Bofete;2014;1676;1012;664;3506904
Bofete;2015;1850;1184;666;3506904
Bofete;2016;1815;1148;667;3506904
Bofete;2017;1899;1263;636;3506904
Boituva;2013;21127;13136;7991;3507001
Boituva;2014;19664;11949;7715;3507001
Boituva;2015;22215;13870;8345;3507001
Boituva;2016;21232;13160;8072;3507001
Boituva;2017;23005;14430;8575;3507001
Bom Jesus dos Perdões;2013;4531;2760;1771;3507100
Bom Jesus dos Perdões;2014;4478;2619;1859;3507100
Bom Jesus dos Perdões;2015;5219;3223;1996;3507100
Bom Jesus dos Perdões;2016;4873;3003;1870;3507100
Bom Jesus dos Perdões;2017;4913;3055;1858;3507100
Bom Sucesso de Itararé;2013;544;394;150;3507159
Bom Sucesso de Itararé;2014;544;371;173;3507159
Bom Sucesso de Itararé;2015;572;369;203;3507159
Bom Sucesso de Itararé;2016;484;301;183;3507159
Bom Sucesso de Itararé;2017;508;324;184;3507159
Borá;2013;1760;1440;320;3507209
Borá;2014;1555;1271;284;3507209
Borá;2015;1501;1240;261;3507209
Borá;2016;1369;1140;229;3507209
Borá;2017;1079;862;217;3507209
Boracéia;2013;1342;862;480;3507308
Boracéia;2014;1323;880;443;3507308
Boracéia;2015;1171;771;400;3507308
Boracéia;2016;1216;826;390;3507308
Boracéia;2017;1282;912;370;3507308
Borborema;2013;2961;1539;1422;3507407
Borborema;2014;2986;1540;1446;3507407
Borborema;2015;2907;1556;1351;3507407
Borborema;2016;2767;1502;1265;3507407
Borborema;2017;2877;1555;1322;3507407
Borebi;2013;763;431;332;3507456
Borebi;2014;746;407;339;3507456
Borebi;2015;666;380;286;3507456
Borebi;2016;659;385;274;3507456
Borebi;2017;655;390;265;3507456
Botucatu;2013;41382;24515;16867;3507506
Botucatu;2014;41687;24640;17047;3507506
Botucatu;2015;41184;23513;17671;3507506
Botucatu;2016;38950;21775;17175;3507506
Botucatu;2017;39415;22365;17050;3507506
Bragança Paulista;2013;42578;22724;19854;3507605
Bragança Paulista;2014;43186;22928;20258;3507605
Bragança Paulista;2015;42494;22567;19927;3507605
Bragança Paulista;2016;43033;22695;20338;3507605
Bragança Paulista;2017;43297;23094;20203;3507605
Braúna;2013;629;327;302;3507704
Braúna;2014;634;321;313;3507704
Braúna;2015;617;331;286;3507704
Braúna;2016;516;292;224;3507704
Braúna;2017;510;294;216;3507704
Brejo Alegre;2013;2733;2402;331;3507753
Brejo Alegre;2014;5469;4962;507;3507753
Brejo Alegre;2015;2044;1792;252;3507753
Brejo Alegre;2016;1912;1678;234;3507753
Brejo Alegre;2017;1472;1248;224;3507753
Brodowski;2013;4525;2322;2203;3507803
Brodowski;2014;4863;2491;2372;3507803
Brodowski;2015;5087;2813;2274;3507803
Brodowski;2016;4946;2666;2280;3507803
Brodowski;2017;4983;2579;2404;3507803
Brotas;2013;7461;4920;2541;3507902
Brotas;2014;6737;4142;2595;3507902
Brotas;2015;7545;4901;2644;3507902
Brotas;2016;6634;4145;2489;3507902
Brotas;2017;5895;3467;2428;3507902
Buri;2013;3891;2567;1324;3508009
Buri;2014;4083;2678;1405;3508009
Buri;2015;4149;2782;1367;3508009
Buri;2016;4159;2810;1349;3508009
Buri;2017;4579;3066;1513;3508009
Buritama;2013;2807;1511;1296;3508108
Buritama;2014;4171;2617;1554;3508108
Buritama;2015;4164;2841;1323;3508108
Buritama;2016;4137;2860;1277;3508108
Buritama;2017;4108;2762;1346;3508108
Buritizal;2013;1744;1418;326;3508207
Buritizal;2014;1701;1353;348;3508207
Buritizal;2015;1742;1416;326;3508207
Buritizal;2016;1745;1440;305;3508207
Buritizal;2017;1711;1419;292;3508207
Cabrália Paulista;2013;835;545;290;3508306
Cabrália Paulista;2014;1027;587;440;3508306
Cabrália Paulista;2015;998;592;406;3508306
Cabrália Paulista;2016;969;600;369;3508306
Cabrália Paulista;2017;958;623;335;3508306
Cabreúva;2013;14695;8959;5736;3508405
Cabreúva;2014;14747;8983;5764;3508405
Cabreúva;2015;14319;8742;5577;3508405
Cabreúva;2016;14038;8703;5335;3508405
Cabreúva;2017;13804;8534;5270;3508405
Cachoeira Paulista;2013;5571;2947;2624;3508603
Cachoeira Paulista;2014;5692;3055;2637;3508603
Cachoeira Paulista;2015;5845;3127;2718;3508603
Cachoeira Paulista;2016;5338;2774;2564;3508603
Cachoeira Paulista;2017;5318;2736;2582;3508603
Caconde;2013;2134;1262;872;3508702
Caconde;2014;2297;1350;947;3508702
Caconde;2015;2242;1314;928;3508702
Caconde;2016;2088;1246;842;3508702
Caconde;2017;2142;1229;913;3508702
Cafelândia;2013;3696;2158;1538;3508801
Cafelândia;2014;3636;2031;1605;3508801
Cafelândia;2015;3621;2169;1452;3508801
Cafelândia;2016;3662;2075;1587;3508801
Cafelândia;2017;3927;2407;1520;3508801
Caiabu;2013;358;157;201;3508900
Caiabu;2014;424;208;216;3508900
Caiabu;2015;373;159;214;3508900
Caiabu;2016;371;154;217;3508900
Caiabu;2017;354;155;199;3508900
Caieiras;2013;23586;15505;8081;3509007
Caieiras;2014;23556;15526;8030;3509007
Caieiras;2015;23492;15114;8378;3509007
Caieiras;2016;18601;11824;6777;3509007
Caieiras;2017;20415;13223;7192;3509007
Caiuá;2013;541;324;217;3509106
Caiuá;2014;564;343;221;3509106
Caiuá;2015;543;327;216;3509106
Caiuá;2016;592;354;238;3509106
Caiuá;2017;545;321;224;3509106
Cajamar;2013;41352;24348;17004;3509205
Cajamar;2014;43747;25741;18006;3509205
Cajamar;2015;41787;24343;17444;3509205
Cajamar;2016;38347;22406;15941;3509205
Cajamar;2017;37601;22473;15128;3509205
Cajati;2013;5659;4035;1624;3509254
Cajati;2014;5802;4145;1657;3509254
Cajati;2015;5822;4099;1723;3509254
Cajati;2016;5835;4142;1693;3509254
Cajati;2017;6335;4524;1811;3509254
Cajobi;2013;1373;738;635;3509304
Cajobi;2014;1341;681;660;3509304
Cajobi;2015;1320;666;654;3509304
Cajobi;2016;1311;685;626;3509304
Cajobi;2017;1358;732;626;3509304
Cajuru;2013;4842;2639;2203;3509403
Cajuru;2014;4813;2554;2259;3509403
Cajuru;2015;4886;2602;2284;3509403
Cajuru;2016;4811;2469;2342;3509403
Cajuru;2017;4747;2582;2165;3509403
Campina do Monte Alegre;2013;843;434;409;3509452
Campina do Monte Alegre;2014;718;386;332;3509452
Campina do Monte Alegre;2015;704;391;313;3509452
Campina do Monte Alegre;2016;681;370;311;3509452
Campina do Monte Alegre;2017;679;372;307;3509452
Campinas;2013;436561;233370;203191;3509502
Campinas;2014;439864;234230;205634;3509502
Campinas;2015;418860;224221;194639;3509502
Campinas;2016;408258;214116;194142;3509502
Campinas;2017;405324;212083;193241;3509502
Campo Limpo Paulista;2013;13560;8435;5125;3509601
Campo Limpo Paulista;2014;13193;8195;4998;3509601
Campo Limpo Paulista;2015;12789;7795;4994;3509601
Campo Limpo Paulista;2016;12303;7506;4797;3509601
Campo Limpo Paulista;2017;12870;7937;4933;3509601
Campos do Jordão;2013;12474;6372;6102;3509700
Campos do Jordão;2014;12819;6545;6274;3509700
Campos do Jordão;2015;12948;6631;6317;3509700
Campos do Jordão;2016;12441;6522;5919;3509700
Campos do Jordão;2017;12283;6450;5833;3509700
Campos Novos Paulista;2013;637;419;218;3509809
Campos Novos Paulista;2014;586;369;217;3509809
Campos Novos Paulista;2015;662;420;242;3509809
Campos Novos Paulista;2016;642;399;243;3509809
Campos Novos Paulista;2017;715;459;256;3509809
Cananéia;2013;1410;823;587;3509908
Cananéia;2014;1445;834;611;3509908
Cananéia;2015;1605;909;696;3509908
Cananéia;2016;1506;841;665;3509908
Cananéia;2017;1586;867;719;3509908
Canas;2013;773;522;251;3509957
Canas;2014;1539;1247;292;3509957
Canas;2015;1506;1192;314;3509957
Canas;2016;1419;1122;297;3509957
Canas;2017;1385;1090;295;3509957
Cândido Mota;2013;5103;3243;1860;3510005
Cândido Mota;2014;4931;3085;1846;3510005
Cândido Mota;2015;5120;3204;1916;3510005
Cândido Mota;2016;5119;3198;1921;3510005
Cândido Mota;2017;5326;3390;1936;3510005
Cândido Rodrigues;2013;664;336;328;3510104
Cândido Rodrigues;2014;689;359;330;3510104
Cândido Rodrigues;2015;727;372;355;3510104
Cândido Rodrigues;2016;730;393;337;3510104
Cândido Rodrigues;2017;709;379;330;3510104
Canitar;2013;899;606;293;3510153
Canitar;2014;790;526;264;3510153
Canitar;2015;1037;752;285;3510153
Canitar;2016;730;478;252;3510153
Canitar;2017;699;460;239;3510153
Capão Bonito;2013;7661;4623;3038;3510203
Capão Bonito;2014;7658;4556;3102;3510203
Capão Bonito;2015;7781;4662;3119;3510203
Capão Bonito;2016;8001;4850;3151;3510203
Capão Bonito;2017;8240;5015;3225;3510203
Capela do Alto;2013;3648;2079;1569;3510302
Capela do Alto;2014;3155;1807;1348;3510302
Capela do Alto;2015;3536;2070;1466;3510302
Capela do Alto;2016;3474;2073;1401;3510302
Capela do Alto;2017;3566;2159;1407;3510302
Capivari;2013;15305;8858;6447;3510401
Capivari;2014;14872;8458;6414;3510401
Capivari;2015;13913;7780;6133;3510401
Capivari;2016;14026;7879;6147;3510401
Capivari;2017;14710;8182;6528;3510401
Caraguatatuba;2013;22322;11240;11082;3510500
Caraguatatuba;2014;22538;11285;11253;3510500
Caraguatatuba;2015;22426;11150;11276;3510500
Caraguatatuba;2016;23102;11932;11170;3510500
Caraguatatuba;2017;23524;12148;11376;3510500
Carapicuíba;2013;45284;24108;21176;3510609
Carapicuíba;2014;38361;21916;16445;3510609
Carapicuíba;2015;37303;21635;15668;3510609
Carapicuíba;2016;35524;19980;15544;3510609
Carapicuíba;2017;35888;20479;15409;3510609
Cardoso;2013;1385;735;650;3510708
Cardoso;2014;1502;808;694;3510708
Cardoso;2015;1461;792;669;3510708
Cardoso;2016;1423;768;655;3510708
Cardoso;2017;1439;804;635;3510708
Casa Branca;2013;6581;3968;2613;3510807
Casa Branca;2014;6463;3893;2570;3510807
Casa Branca;2015;6547;3950;2597;3510807
Casa Branca;2016;6243;3756;2487;3510807
Casa Branca;2017;6676;4020;2656;3510807
Cássia dos Coqueiros;2013;486;267;219;3510906
Cássia dos Coqueiros;2014;490;254;236;3510906
Cássia dos Coqueiros;2015;483;251;232;3510906
Cássia dos Coqueiros;2016;461;234;227;3510906
Cássia dos Coqueiros;2017;508;246;262;3510906
Castilho;2013;3345;2154;1191;3511003
Castilho;2014;3493;2162;1331;3511003
Castilho;2015;3247;1978;1269;3511003
Castilho;2016;3082;1947;1135;3511003
Castilho;2017;3131;1985;1146;3511003
Catanduva;2013;40126;23424;16702;3511102
Catanduva;2014;41171;24576;16595;3511102
Catanduva;2015;36719;20938;15781;3511102
Catanduva;2016;34888;19876;15012;3511102
Catanduva;2017;34545;19968;14577;3511102
Catiguá;2013;1012;629;383;3511201
Catiguá;2014;961;580;381;3511201
Catiguá;2015;957;558;399;3511201
Catiguá;2016;941;565;376;3511201
Catiguá;2017;821;471;350;3511201
Caçapava;2013;22263;14007;8256;3508504
Caçapava;2014;22628;13945;8683;3508504
Caçapava;2015;22011;13768;8243;3508504
Caçapava;2016;21149;13217;7932;3508504
Caçapava;2017;21272;13141;8131;3508504
Cedral;2013;2319;1307;1012;3511300
Cedral;2014;2564;1441;1123;3511300
Cedral;2015;2715;1544;1171;3511300
Cedral;2016;2398;1412;986;3511300
Cedral;2017;4535;2193;2342;3511300
Cerqueira César;2013;5008;3087;1921;3511409
Cerqueira César;2014;4854;2928;1926;3511409
Cerqueira César;2015;4523;2734;1789;3511409
Cerqueira César;2016;4617;2806;1811;3511409
Cerqueira César;2017;4846;3038;1808;3511409
Cerquilho;2013;12281;7201;5080;3511508
Cerquilho;2014;13245;7473;5772;3511508
Cerquilho;2015;12671;7418;5253;3511508
Cerquilho;2016;12314;7178;5136;3511508
Cerquilho;2017;12246;7169;5077;3511508
Cesário Lange;2013;3393;1993;1400;3511607
Cesário Lange;2014;3411;2037;1374;3511607
Cesário Lange;2015;3625;2230;1395;3511607
Cesário Lange;2016;3493;2176;1317;3511607
Cesário Lange;2017;3578;2225;1353;3511607
Charqueada;2013;2901;1614;1287;3511706
Charqueada;2014;2888;1590;1298;3511706
Charqueada;2015;2706;1555;1151;3511706
Charqueada;2016;2458;1431;1027;3511706
Charqueada;2017;2514;1552;962;3511706
Chavantes;2013;2092;1298;794;3557204
Chavantes;2014;2081;1294;787;3557204
Chavantes;2015;1997;1246;751;3557204
Chavantes;2016;1836;1097;739;3557204
Chavantes;2017;1804;1078;726;3557204
Clementina;2013;3585;3050;535;3511904
Clementina;2014;3987;3309;678;3511904
Clementina;2015;3768;3258;510;3511904
Clementina;2016;3997;3553;444;3511904
Clementina;2017;3792;3295;497;3511904
Colina;2013;5290;3576;1714;3512001
Colina;2014;5259;3417;1842;3512001
Colina;2015;5402;3596;1806;3512001
Colina;2016;5019;3286;1733;3512001
Colina;2017;5129;3251;1878;3512001
Colômbia;2013;3459;2457;1002;3512100
Colômbia;2014;4168;2913;1255;3512100
Colômbia;2015;4451;3246;1205;3512100
Colômbia;2016;3304;2440;864;3512100
Colômbia;2017;5261;3862;1399;3512100
Conchal;2013;5928;3169;2759;3512209
Conchal;2014;6108;3332;2776;3512209
Conchal;2015;5929;3266;2663;3512209
Conchal;2016;5606;3057;2549;3512209
Conchal;2017;5648;3079;2569;3512209
Conchas;2013;3327;1991;1336;3512308
Conchas;2014;3369;1957;1412;3512308
Conchas;2015;3381;1963;1418;3512308
Conchas;2016;3573;2006;1567;3512308
Conchas;2017;3320;1876;1444;3512308
Cordeirópolis;2013;9561;6387;3174;3512407
Cordeirópolis;2014;9492;6240;3252;3512407
Cordeirópolis;2015;9696;6351;3345;3512407
Cordeirópolis;2016;9250;6055;3195;3512407
Cordeirópolis;2017;9418;6179;3239;3512407
Coroados;2013;905;593;312;3512506
Coroados;2014;906;588;318;3512506
Coroados;2015;910;591;319;3512506
Coroados;2016;884;591;293;3512506
Coroados;2017;958;616;342;3512506
Coronel Macedo;2013;665;411;254;3512605
Coronel Macedo;2014;718;445;273;3512605
Coronel Macedo;2015;706;429;277;3512605
Coronel Macedo;2016;841;571;270;3512605
Coronel Macedo;2017;816;552;264;3512605
Corumbataí;2013;1053;704;349;3512704
Corumbataí;2014;1088;738;350;3512704
Corumbataí;2015;1120;754;366;3512704
Corumbataí;2016;1126;772;354;3512704
Corumbataí;2017;1040;738;302;3512704
Cosmópolis;2013;10772;6099;4673;3512803
Cosmópolis;2014;10424;5722;4702;3512803
Cosmópolis;2015;10200;5751;4449;3512803
Cosmópolis;2016;9763;5387;4376;3512803
Cosmópolis;2017;9160;5128;4032;3512803
Cosmorama;2013;2263;1608;655;3512902
Cosmorama;2014;2507;1864;643;3512902
Cosmorama;2015;2128;1560;568;3512902
Cosmorama;2016;1536;1060;476;3512902
Cosmorama;2017;1961;1437;524;3512902
Cotia;2013;76692;44275;32417;3513009
Cotia;2014;79178;45413;33765;3513009
Cotia;2015;79237;44864;34373;3513009
Cotia;2016;72967;40352;32615;3513009
Cotia;2017;72429;40216;32213;3513009
Cravinhos;2013;8806;5388;3418;3513108
Cravinhos;2014;8860;5374;3486;3513108
Cravinhos;2015;8575;5122;3453;3513108
Cravinhos;2016;8388;5111;3277;3513108
Cravinhos;2017;8681;5446;3235;3513108
Cristais Paulista;2013;1539;1041;498;3513207
Cristais Paulista;2014;1525;1011;514;3513207
Cristais Paulista;2015;1481;954;527;3513207
Cristais Paulista;2016;1739;1152;587;3513207
Cristais Paulista;2017;1733;1107;626;3513207
Cruzália;2013;388;199;189;3513306
Cruzália;2014;421;222;199;3513306
Cruzália;2015;404;224;180;3513306
Cruzália;2016;439;250;189;3513306
Cruzália;2017;389;227;162;3513306
Cruzeiro;2013;18569;12386;6183;3513405
Cruzeiro;2014;18198;12118;6080;3513405
Cruzeiro;2015;16747;10770;5977;3513405
Cruzeiro;2016;16016;10375;5641;3513405
Cruzeiro;2017;15781;10190;5591;3513405
Cubatão;2013;40928;29454;11474;3513504
Cubatão;2014;38770;27103;11667;3513504
Cubatão;2015;35975;25088;10887;3513504
Cubatão;2016;29051;18950;10101;3513504
Cubatão;2017;26402;17494;8908;3513504
Cunha;2013;1921;1220;701;3513603
Cunha;2014;1993;1246;747;3513603
Cunha;2015;2126;1324;802;3513603
Cunha;2016;2141;1295;846;3513603
Cunha;2017;2298;1394;904;3513603
Descalvado;2013;9520;6003;3517;3513702
Descalvado;2014;9032;5817;3215;3513702
Descalvado;2015;9267;6125;3142;3513702
Descalvado;2016;9093;5840;3253;3513702
Descalvado;2017;9680;6375;3305;3513702
Diadema;2013;111520;71005;40515;3513801
Diadema;2014;107575;67505;40070;3513801
Diadema;2015;100798;62702;38096;3513801
Diadema;2016;91960;56675;35285;3513801
Diadema;2017;88832;54342;34490;3513801
Dirce Reis;2013;363;252;111;3513850
Dirce Reis;2014;318;228;90;3513850
Dirce Reis;2015;317;225;92;3513850
Dirce Reis;2016;318;222;96;3513850
Dirce Reis;2017;325;228;97;3513850
Divinolândia;2013;2017;924;1093;3513900
Divinolândia;2014;2142;1000;1142;3513900
Divinolândia;2015;2229;1022;1207;3513900
Divinolândia;2016;2302;1048;1254;3513900
Divinolândia;2017;2237;1018;1219;3513900
Dobrada;2013;629;346;283;3514007
Dobrada;2014;702;384;318;3514007
Dobrada;2015;716;403;313;3514007
Dobrada;2016;698;369;329;3514007
Dobrada;2017;708;383;325;3514007
Dois Córregos;2013;6091;3756;2335;3514106
Dois Córregos;2014;6127;3773;2354;3514106
Dois Córregos;2015;5581;3390;2191;3514106
Dois Córregos;2016;5394;3261;2133;3514106
Dois Córregos;2017;5032;2939;2093;3514106
Dolcinópolis;2013;319;161;158;3514205
Dolcinópolis;2014;316;163;153;3514205
Dolcinópolis;2015;315;164;151;3514205
Dolcinópolis;2016;288;152;136;3514205
Dolcinópolis;2017;290;148;142;3514205
Dourado;2013;2021;1271;750;3514304
Dourado;2014;2195;1343;852;3514304
Dourado;2015;2144;1334;810;3514304
Dourado;2016;2267;1429;838;3514304
Dourado;2017;2664;1610;1054;3514304
Dracena;2013;10992;6199;4793;3514403
Dracena;2014;11277;6326;4951;3514403
Dracena;2015;11094;6189;4905;3514403
Dracena;2016;10878;6008;4870;3514403
Dracena;2017;10993;5969;5024;3514403
Duartina;2013;2209;1187;1022;3514502
Duartina;2014;2281;1251;1030;3514502
Duartina;2015;2298;1296;1002;3514502
Duartina;2016;2065;1090;975;3514502
Duartina;2017;2214;1270;944;3514502
Dumont;2013;1833;958;875;3514601
Dumont;2014;1645;914;731;3514601
Dumont;2015;1916;1051;865;3514601
Dumont;2016;1975;1115;860;3514601
Dumont;2017;1973;1093;880;3514601
Echaporã;2013;766;469;297;3514700
Echaporã;2014;759;472;287;3514700
Echaporã;2015;768;485;283;3514700
Echaporã;2016;874;518;356;3514700
Echaporã;2017;855;530;325;3514700
Eldorado;2013;2115;1458;657;3514809
Eldorado;2014;2065;1353;712;3514809
Eldorado;2015;1987;1286;701;3514809
Eldorado;2016;2106;1359;747;3514809
Eldorado;2017;2148;1459;689;3514809
Elias Fausto;2013;4781;3226;1555;3514908
Elias Fausto;2014;4700;3180;1520;3514908
Elias Fausto;2015;4556;3228;1328;3514908
Elias Fausto;2016;4478;3174;1304;3514908
Elias Fausto;2017;4635;3286;1349;3514908
Elisiário;2013;538;335;203;3514924
Elisiário;2014;551;345;206;3514924
Elisiário;2015;542;351;191;3514924
Elisiário;2016;553;369;184;3514924
Elisiário;2017;561;372;189;3514924
Embaúba;2013;381;226;155;3514957
Embaúba;2014;409;235;174;3514957
Embaúba;2015;382;212;170;3514957
Embaúba;2016;349;187;162;3514957
Embaúba;2017;364;195;169;3514957
Embu das Artes;2013;44988;27610;17378;3515004
Embu das Artes;2014;45712;27610;18102;3515004
Embu das Artes;2015;43977;26469;17508;3515004
Embu das Artes;2016;42420;25445;16975;3515004
Embu das Artes;2017;42868;25743;17125;3515004
Embu-Guaçu;2013;8350;4913;3437;3515103
Embu-Guaçu;2014;8224;4764;3460;3515103
Embu-Guaçu;2015;8451;4867;3584;3515103
Embu-Guaçu;2016;8485;4927;3558;3515103
Embu-Guaçu;2017;7735;4425;3310;3515103
Emilianópolis;2013;339;178;161;3515129
Emilianópolis;2014;328;176;152;3515129
Emilianópolis;2015;343;181;162;3515129
Emilianópolis;2016;323;170;153;3515129
Emilianópolis;2017;353;186;167;3515129
Engenheiro Coelho;2013;3808;2260;1548;3515152
Engenheiro Coelho;2014;3594;2115;1479;3515152
Engenheiro Coelho;2015;3936;2249;1687;3515152
Engenheiro Coelho;2016;3876;2242;1634;3515152
Engenheiro Coelho;2017;4325;2579;1746;3515152
Espírito Santo do Pinhal;2013;12654;7026;5628;3515186
Espírito Santo do Pinhal;2014;12491;6830;5661;3515186
Espírito Santo do Pinhal;2015;12430;6942;5488;3515186
Espírito Santo do Pinhal;2016;12231;6817;5414;3515186
Espírito Santo do Pinhal;2017;11883;6570;5313;3515186
Espírito Santo do Turvo;2013;536;295;241;3515194
Espírito Santo do Turvo;2014;512;258;254;3515194
Espírito Santo do Turvo;2015;556;310;246;3515194
Espírito Santo do Turvo;2016;454;212;242;3515194
Espírito Santo do Turvo;2017;542;276;266;3515194
Estiva Gerbi;2013;1841;1121;720;3557303
Estiva Gerbi;2014;1877;1169;708;3557303
Estiva Gerbi;2015;1934;1202;732;3557303
Estiva Gerbi;2016;1817;1160;657;3557303
Estiva Gerbi;2017;2387;1640;747;3557303
Estrela d'Oeste;2013;3184;1820;1364;3515202
Estrela d'Oeste;2014;2871;1682;1189;3515202
Estrela d'Oeste;2015;2840;1718;1122;3515202
Estrela d'Oeste;2016;2674;1616;1058;3515202
Estrela d'Oeste;2017;4194;2565;1629;3515202
Estrela do Norte;2013;402;173;229;3515301
Estrela do Norte;2014;382;157;225;3515301
Estrela do Norte;2015;355;153;202;3515301
Estrela do Norte;2016;532;317;215;3515301
Estrela do Norte;2017;454;235;219;3515301
Euclides da Cunha Paulista;2013;749;373;376;3515350
Euclides da Cunha Paulista;2014;666;307;359;3515350
Euclides da Cunha Paulista;2015;784;398;386;3515350
Euclides da Cunha Paulista;2016;727;352;375;3515350
Euclides da Cunha Paulista;2017;712;345;367;3515350
Fartura;2013;3803;2004;1799;3515400
Fartura;2014;3814;1939;1875;3515400
Fartura;2015;3756;1960;1796;3515400
Fartura;2016;3616;1896;1720;3515400
Fartura;2017;3813;2002;1811;3515400
Fernando Prestes;2013;1068;502;566;3515608
Fernando Prestes;2014;1115;520;595;3515608
Fernando Prestes;2015;1059;575;484;3515608
Fernando Prestes;2016;1106;599;507;3515608
Fernando Prestes;2017;1212;678;534;3515608
Fernandópolis;2013;17113;9701;7412;3515509
Fernandópolis;2014;17630;9880;7750;3515509
Fernandópolis;2015;17173;9965;7208;3515509
Fernandópolis;2016;17255;9915;7340;3515509
Fernandópolis;2017;16641;9304;7337;3515509
Fernão;2013;332;203;129;3515657
Fernão;2014;374;226;148;3515657
Fernão;2015;415;260;155;3515657
Fernão;2016;357;219;138;3515657
Fernão;2017;357;219;138;3515657
Ferraz de Vasconcelos;2013;21876;13630;8246;3515707
Ferraz de Vasconcelos;2014;21218;12901;8317;3515707
Ferraz de Vasconcelos;2015;20292;12347;7945;3515707
Ferraz de Vasconcelos;2016;19617;11577;8040;3515707
Ferraz de Vasconcelos;2017;19046;11423;7623;3515707
Flora Rica;2013;284;156;128;3515806
Flora Rica;2014;272;148;124;3515806
Flora Rica;2015;256;146;110;3515806
Flora Rica;2016;264;139;125;3515806
Flora Rica;2017;272;144;128;3515806
Floreal;2013;488;280;208;3515905
Floreal;2014;484;272;212;3515905
Floreal;2015;475;267;208;3515905
Floreal;2016;489;271;218;3515905
Floreal;2017;468;251;217;3515905
Flórida Paulista;2013;2842;1983;859;3516002
Flórida Paulista;2014;1581;996;585;3516002
Flórida Paulista;2015;2311;1642;669;3516002
Flórida Paulista;2016;1394;863;531;3516002
Flórida Paulista;2017;1207;714;493;3516002
Florínia;2013;498;288;210;3516101
Florínia;2014;550;312;238;3516101
Florínia;2015;536;325;211;3516101
Florínia;2016;523;313;210;3516101
Florínia;2017;524;321;203;3516101
Franca;2013;92035;50436;41599;3516200
Franca;2014;89794;48506;41288;3516200
Franca;2015;85991;46031;39960;3516200
Franca;2016;84688;44831;39857;3516200
Franca;2017;84840;45461;39379;3516200
Francisco Morato;2013;9289;4519;4770;3516309
Francisco Morato;2014;9455;4303;5152;3516309
Francisco Morato;2015;9801;4337;5464;3516309
Francisco Morato;2016;9386;4084;5302;3516309
Francisco Morato;2017;9522;4163;5359;3516309
Franco da Rocha;2013;14126;7978;6148;3516408
Franco da Rocha;2014;15120;8413;6707;3516408
Franco da Rocha;2015;14846;8034;6812;3516408
Franco da Rocha;2016;15153;7979;7174;3516408
Franco da Rocha;2017;16258;8534;7724;3516408
Gabriel Monteiro;2013;849;362;487;3516507
Gabriel Monteiro;2014;881;357;524;3516507
Gabriel Monteiro;2015;963;375;588;3516507
Gabriel Monteiro;2016;952;369;583;3516507
Gabriel Monteiro;2017;1002;375;627;3516507
Gália;2013;1415;940;475;3516606
Gália;2014;1535;1002;533;3516606
Gália;2015;1295;833;462;3516606
Gália;2016;1379;874;505;3516606
Gália;2017;1402;757;645;3516606
Garça;2013;11774;6845;4929;3516705
Garça;2014;12154;7065;5089;3516705
Garça;2015;10835;6300;4535;3516705
Garça;2016;10553;6124;4429;3516705
Garça;2017;10409;6058;4351;3516705
Gastão Vidigal;2013;465;311;154;3516804
Gastão Vidigal;2014;454;280;174;3516804
Gastão Vidigal;2015;343;188;155;3516804
Gastão Vidigal;2016;419;251;168;3516804
Gastão Vidigal;2017;448;270;178;3516804
Gavião Peixoto;2013;3236;2477;759;3516853
Gavião Peixoto;2014;3206;2406;800;3516853
Gavião Peixoto;2015;3180;2387;793;3516853
Gavião Peixoto;2016;3266;2537;729;3516853
Gavião Peixoto;2017;3645;2873;772;3516853
General Salgado;2013;1750;1015;735;3516903
General Salgado;2014;1560;833;727;3516903
General Salgado;2015;1526;811;715;3516903
General Salgado;2016;1489;777;712;3516903
General Salgado;2017;1310;720;590;3516903
Getulina;2013;1150;648;502;3517000
Getulina;2014;1218;689;529;3517000
Getulina;2015;1205;712;493;3517000
Getulina;2016;1109;638;471;3517000
Getulina;2017;1167;680;487;3517000
Glicério;2013;1020;561;459;3517109
Glicério;2014;936;494;442;3517109
Glicério;2015;914;513;401;3517109
Glicério;2016;891;480;411;3517109
Glicério;2017;999;542;457;3517109
Guaimbê;2013;539;310;229;3517307
Guaimbê;2014;606;346;260;3517307
Guaimbê;2015;643;378;265;3517307
Guaimbê;2016;543;306;237;3517307
Guaimbê;2017;638;374;264;3517307
Guaíra;2013;12745;9217;3528;3517406
Guaíra;2014;12660;8967;3693;3517406
Guaíra;2015;13100;9455;3645;3517406
Guaíra;2016;14138;10341;3797;3517406
Guaíra;2017;14146;10371;3775;3517406
Guaiçara;2013;1628;925;703;3517208
Guaiçara;2014;1986;1264;722;3517208
Guaiçara;2015;1713;968;745;3517208
Guaiçara;2016;1646;929;717;3517208
Guaiçara;2017;1691;972;719;3517208
Guapiara;2013;2020;1421;599;3517604
Guapiara;2014;2095;1424;671;3517604
Guapiara;2015;1982;1339;643;3517604
Guapiara;2016;2032;1379;653;3517604
Guapiara;2017;1970;1299;671;3517604
Guapiaçu;2013;3172;1978;1194;3517505
Guapiaçu;2014;3666;2128;1538;3517505
Guapiaçu;2015;4235;2370;1865;3517505
Guapiaçu;2016;4155;2345;1810;3517505
Guapiaçu;2017;4105;2438;1667;3517505
Guará;2013;4028;2446;1582;3517703
Guará;2014;2931;1597;1334;3517703
Guará;2015;2420;1149;1271;3517703
Guará;2016;2463;1193;1270;3517703
Guará;2017;2580;1364;1216;3517703
Guaraci;2013;2168;1529;639;3517901
Guaraci;2014;2251;1583;668;3517901
Guaraci;2015;2234;1551;683;3517901
Guaraci;2016;2248;1571;677;3517901
Guaraci;2017;2498;1649;849;3517901
Guarani d'Oeste;2013;285;131;154;3518008
Guarani d'Oeste;2014;327;159;168;3518008
Guarani d'Oeste;2015;326;153;173;3518008
Guarani d'Oeste;2016;345;173;172;3518008
Guarani d'Oeste;2017;321;160;161;3518008
Guarantã;2013;1355;825;530;3518107
Guarantã;2014;1321;812;509;3518107
Guarantã;2015;1349;827;522;3518107
Guarantã;2016;1308;789;519;3518107
Guarantã;2017;1302;796;506;3518107
Guararapes;2013;6597;4217;2380;3518206
Guararapes;2014;6364;3900;2464;3518206
Guararapes;2015;6703;4319;2384;3518206
Guararapes;2016;6658;4335;2323;3518206
Guararapes;2017;6641;4262;2379;3518206
Guararema;2013;7189;4350;2839;3518305
Guararema;2014;7580;4599;2981;3518305
Guararema;2015;7331;4421;2910;3518305
Guararema;2016;7988;4716;3272;3518305
Guararema;2017;7590;4444;3146;3518305
Guaratinguetá;2013;31364;19742;11622;3518404
Guaratinguetá;2014;31415;19778;11637;3518404
Guaratinguetá;2015;30788;19216;11572;3518404
Guaratinguetá;2016;30250;18857;11393;3518404
Guaratinguetá;2017;30731;19058;11673;3518404
Guaraçaí;2013;1296;734;562;3517802
Guaraçaí;2014;1340;765;575;3517802
Guaraçaí;2015;1390;801;589;3517802
Guaraçaí;2016;1312;732;580;3517802
Guaraçaí;2017;1388;790;598;3517802
Guareí;2013;2207;1234;973;3518503
Guareí;2014;2259;1221;1038;3518503
Guareí;2015;2158;1170;988;3518503
Guareí;2016;2226;1219;1007;3518503
Guareí;2017;2339;1319;1020;3518503
Guariba;2013;7649;5132;2517;3518602
Guariba;2014;7332;4731;2601;3518602
Guariba;2015;7353;4793;2560;3518602
Guariba;2016;7022;4523;2499;3518602
Guariba;2017;7073;4541;2532;3518602
Guarujá;2013;52348;31206;21142;3518701
Guarujá;2014;52551;31130;21421;3518701
Guarujá;2015;52731;31132;21599;3518701
Guarujá;2016;50080;29301;20779;3518701
Guarujá;2017;47693;27740;19953;3518701
Guarulhos;2013;354409;221275;133134;3518800
Guarulhos;2014;357417;217885;139532;3518800
Guarulhos;2015;341760;205709;136051;3518800
Guarulhos;2016;320704;190845;129859;3518800
Guarulhos;2017;320416;191614;128802;3518800
Guatapará;2013;1645;896;749;3518859
Guatapará;2014;1768;900;868;3518859
Guatapará;2015;1786;792;994;3518859
Guatapará;2016;1672;850;822;3518859
Guatapará;2017;1383;752;631;3518859
Guzolândia;2013;547;299;248;3518909
Guzolândia;2014;562;303;259;3518909
Guzolândia;2015;567;317;250;3518909
Guzolândia;2016;582;308;274;3518909
Guzolândia;2017;633;339;294;3518909
Herculândia;2013;1217;771;446;3519006
Herculândia;2014;1209;775;434;3519006
Herculândia;2015;1209;756;453;3519006
Herculândia;2016;1201;756;445;3519006
Herculândia;2017;1270;807;463;3519006
Holambra;2013;7361;3828;3533;3519055
Holambra;2014;7488;3836;3652;3519055
Holambra;2015;7811;4075;3736;3519055
Holambra;2016;8007;4057;3950;3519055
Holambra;2017;8307;4124;4183;3519055
Hortolândia;2013;45912;27957;17955;3519071
Hortolândia;2014;48441;29853;18588;3519071
Hortolândia;2015;44626;26657;17969;3519071
Hortolândia;2016;46266;27742;18524;3519071
Hortolândia;2017;44992;27332;17660;3519071
Iacanga;2013;3450;2448;1002;3519105
Iacanga;2014;3436;2379;1057;3519105
Iacanga;2015;3421;2370;1051;3519105
Iacanga;2016;3292;2299;993;3519105
Iacanga;2017;3549;2533;1016;3519105
Iacri;2013;818;465;353;3519204
Iacri;2014;838;483;355;3519204
Iacri;2015;862;498;364;3519204
Iacri;2016;850;496;354;3519204
Iacri;2017;937;570;367;3519204
Iaras;2013;1687;946;741;3519253
Iaras;2014;1632;959;673;3519253
Iaras;2015;1692;1016;676;3519253
Iaras;2016;1604;972;632;3519253
Iaras;2017;1598;977;621;3519253
Ibaté;2013;6270;4134;2136;3519303
Ibaté;2014;6289;4173;2116;3519303
Ibaté;2015;6328;4319;2009;3519303
Ibaté;2016;5948;3988;1960;3519303
Ibaté;2017;6155;4160;1995;3519303
Ibirá;2013;1890;991;899;3519402
Ibirá;2014;2040;1106;934;3519402
Ibirá;2015;1970;1078;892;3519402
Ibirá;2016;1870;1029;841;3519402
Ibirá;2017;1950;1046;904;3519402
Ibirarema;2013;733;447;286;3519501
Ibirarema;2014;716;441;275;3519501
Ibirarema;2015;743;476;267;3519501
Ibirarema;2016;729;451;278;3519501
Ibirarema;2017;757;498;259;3519501
Ibitinga;2013;15986;8423;7563;3519600
Ibitinga;2014;16123;8388;7735;3519600
Ibitinga;2015;14576;7625;6951;3519600
Ibitinga;2016;13882;7361;6521;3519600
Ibitinga;2017;14370;7633;6737;3519600
Ibiúna;2013;11598;6244;5354;3519709
Ibiúna;2014;12806;6893;5913;3519709
Ibiúna;2015;13184;6885;6299;3519709
Ibiúna;2016;13045;6976;6069;3519709
Ibiúna;2017;13412;7216;6196;3519709
Icém;2013;1152;670;482;3519808
Icém;2014;1175;664;511;3519808
Icém;2015;3561;2731;830;3519808
Icém;2016;3421;2627;794;3519808
Icém;2017;942;493;449;3519808
Iepê;2013;1005;561;444;3519907
Iepê;2014;1049;594;455;3519907
Iepê;2015;1271;661;610;3519907
Iepê;2016;1147;655;492;3519907
Iepê;2017;1136;658;478;3519907
Igarapava;2013;6165;3708;2457;3520103
Igarapava;2014;5776;3338;2438;3520103
Igarapava;2015;5464;3098;2366;3520103
Igarapava;2016;5246;2924;2322;3520103
Igarapava;2017;5224;2940;2284;3520103
Igaratá;2013;1532;910;622;3520202
Igaratá;2014;1522;855;667;3520202
Igaratá;2015;1687;970;717;3520202
Igaratá;2016;1560;899;661;3520202
Igaratá;2017;1646;932;714;3520202
Igaraçu do Tietê;2013;2605;1322;1283;3520004
Igaraçu do Tietê;2014;2639;1365;1274;3520004
Igaraçu do Tietê;2015;2612;1358;1254;3520004
Igaraçu do Tietê;2016;2501;1252;1249;3520004
Igaraçu do Tietê;2017;2448;1238;1210;3520004
Iguape;2013;2638;1385;1253;3520301
Iguape;2014;1850;1037;813;3520301
Iguape;2015;2826;1457;1369;3520301
Iguape;2016;2848;1463;1385;3520301
Iguape;2017;2830;1447;1383;3520301
Ilha Comprida;2013;1498;780;718;3520426
Ilha Comprida;2014;1854;926;928;3520426
Ilha Comprida;2015;1892;950;942;3520426
Ilha Comprida;2016;1854;967;887;3520426
Ilha Comprida;2017;1700;841;859;3520426
Ilha Solteira;2013;5496;2924;2572;3520442
Ilha Solteira;2014;5454;2866;2588;3520442
Ilha Solteira;2015;5265;2750;2515;3520442
Ilha Solteira;2016;4863;2449;2414;3520442
Ilha Solteira;2017;5165;2611;2554;3520442
Ilhabela;2013;7500;3781;3719;3520400
Ilhabela;2014;7308;3784;3524;3520400
Ilhabela;2015;8010;4119;3891;3520400
Ilhabela;2016;8499;4233;4266;3520400
Ilhabela;2017;8547;4341;4206;3520400
Indaiatuba;2013;72463;42624;29833;3520509
Indaiatuba;2014;73499;42697;30802;3520509
Indaiatuba;2015;73050;42698;30352;3520509
Indaiatuba;2016;72751;42166;30585;3520509
Indaiatuba;2017;72513;41371;31142;3520509
Indiana;2013;594;350;244;3520608
Indiana;2014;619;366;253;3520608
Indiana;2015;636;369;267;3520608
Indiana;2016;584;330;254;3520608
Indiana;2017;620;338;282;3520608
Indiaporã;2013;514;284;230;3520707
Indiaporã;2014;530;299;231;3520707
Indiaporã;2015;585;332;253;3520707
Indiaporã;2016;300;184;116;3520707
Indiaporã;2017;556;339;217;3520707
Inúbia Paulista;2013;929;494;435;3520806
Inúbia Paulista;2014;919;495;424;3520806
Inúbia Paulista;2015;941;515;426;3520806
Inúbia Paulista;2016;966;530;436;3520806
Inúbia Paulista;2017;972;541;431;3520806
Ipaussu;2013;3661;2440;1221;3520905
Ipaussu;2014;3484;2279;1205;3520905
Ipaussu;2015;3360;2165;1195;3520905
Ipaussu;2016;3120;1984;1136;3520905
Ipaussu;2017;3225;2055;1170;3520905
Iperó;2013;5795;3576;2219;3521002
Iperó;2014;5758;3478;2280;3521002
Iperó;2015;5070;3056;2014;3521002
Iperó;2016;5134;3100;2034;3521002
Iperó;2017;5704;3510;2194;3521002
Ipeúna;2013;2397;1539;858;3521101
Ipeúna;2014;2134;1325;809;3521101
Ipeúna;2015;2059;1280;779;3521101
Ipeúna;2016;1968;1219;749;3521101
Ipeúna;2017;1944;1202;742;3521101
Ipiguá;2013;841;486;355;3521150
Ipiguá;2014;1036;665;371;3521150
Ipiguá;2015;1071;702;369;3521150
Ipiguá;2016;1071;668;403;3521150
Ipiguá;2017;1341;902;439;3521150
Iporanga;2013;494;269;225;3521200
Iporanga;2014;507;287;220;3521200
Iporanga;2015;548;315;233;3521200
Iporanga;2016;485;286;199;3521200
Iporanga;2017;497;291;206;3521200
Ipuã;2013;3604;2182;1422;3521309
Ipuã;2014;3292;1971;1321;3521309
Ipuã;2015;2838;1620;1218;3521309
Ipuã;2016;3077;1773;1304;3521309
Ipuã;2017;2583;1384;1199;3521309
Iracemápolis;2013;6724;4448;2276;3521408
Iracemápolis;2014;6639;4250;2389;3521408
Iracemápolis;2015;6874;4564;2310;3521408
Iracemápolis;2016;6612;4326;2286;3521408
Iracemápolis;2017;6899;4445;2454;3521408
Irapuã;2013;876;443;433;3521507
Irapuã;2014;904;453;451;3521507
Irapuã;2015;942;492;450;3521507
Irapuã;2016;971;499;472;3521507
Irapuã;2017;947;493;454;3521507
Irapuru;2013;735;399;336;3521606
Irapuru;2014;770;396;374;3521606
Irapuru;2015;820;432;388;3521606
Irapuru;2016;682;338;344;3521606
Irapuru;2017;690;341;349;3521606
Itaberá;2013;2656;1647;1009;3521705
Itaberá;2014;2720;1684;1036;3521705
Itaberá;2015;2608;1617;991;3521705
Itaberá;2016;2532;1591;941;3521705
Itaberá;2017;2760;1773;987;3521705
Itaí;2013;5018;3354;1664;3521804
Itaí;2014;5239;3431;1808;3521804
Itaí;2015;5128;3390;1738;3521804
Itaí;2016;4966;3252;1714;3521804
Itaí;2017;5517;3729;1788;3521804
Itajobi;2013;2949;1816;1133;3521903
Itajobi;2014;3032;1827;1205;3521903
Itajobi;2015;3325;1954;1371;3521903
Itajobi;2016;3214;1924;1290;3521903
Itajobi;2017;3439;2127;1312;3521903
Itaju;2013;670;381;289;3522000
Itaju;2014;618;346;272;3522000
Itaju;2015;756;387;369;3522000
Itaju;2016;731;344;387;3522000
Itaju;2017;756;385;371;3522000
Itanhaém;2013;14766;7111;7655;3522109
Itanhaém;2014;13745;6800;6945;3522109
Itanhaém;2015;14384;7003;7381;3522109
Itanhaém;2016;13881;6768;7113;3522109
Itanhaém;2017;13967;6610;7357;3522109
Itaóca;2013;329;232;97;3522158
Itaóca;2014;321;218;103;3522158
Itaóca;2015;305;204;101;3522158
Itaóca;2016;321;214;107;3522158
Itaóca;2017;340;221;119;3522158
Itapecerica da Serra;2013;23215;13125;10090;3522208
Itapecerica da Serra;2014;23331;12903;10428;3522208
Itapecerica da Serra;2015;23719;13243;10476;3522208
Itapecerica da Serra;2016;22323;11915;10408;3522208
Itapecerica da Serra;2017;21223;11506;9717;3522208
Itapetininga;2013;35682;20497;15185;3522307
Itapetininga;2014;36192;20379;15813;3522307
Itapetininga;2015;36266;20357;15909;3522307
Itapetininga;2016;35421;19912;15509;3522307
Itapetininga;2017;35521;20361;15160;3522307
Itapeva;2013;19846;12101;7745;3522406
Itapeva;2014;20711;12571;8140;3522406
Itapeva;2015;20502;12211;8291;3522406
Itapeva;2016;19847;12010;7837;3522406
Itapeva;2017;19704;11927;7777;3522406
Itapevi;2013;37747;20691;17056;3522505
Itapevi;2014;38818;21219;17599;3522505
Itapevi;2015;38131;21107;17024;3522505
Itapevi;2016;34675;19426;15249;3522505
Itapevi;2017;32535;18210;14325;3522505
Itapira;2013;22848;13600;9248;3522604
Itapira;2014;23145;13625;9520;3522604
Itapira;2015;22980;13583;9397;3522604
Itapira;2016;22666;13474;9192;3522604
Itapira;2017;22898;13645;9253;3522604
Itapirapuã Paulista;2013;521;357;164;3522653
Itapirapuã Paulista;2014;576;392;184;3522653
Itapirapuã Paulista;2015;546;363;183;3522653
Itapirapuã Paulista;2016;574;355;219;3522653
Itapirapuã Paulista;2017;531;331;200;3522653
Itápolis;2013;10474;6300;4174;3522703
Itápolis;2014;10647;6452;4195;3522703
Itápolis;2015;10443;6298;4145;3522703
Itápolis;2016;9642;5791;3851;3522703
Itápolis;2017;10347;6271;4076;3522703
Itaporanga;2013;2067;1108;959;3522802
Itaporanga;2014;2154;1172;982;3522802
Itaporanga;2015;2085;1097;988;3522802
Itaporanga;2016;2013;1080;933;3522802
Itaporanga;2017;2278;1288;990;3522802
Itapuí;2013;4556;2403;2153;3522901
Itapuí;2014;4875;2595;2280;3522901
Itapuí;2015;4536;2486;2050;3522901
Itapuí;2016;4079;2275;1804;3522901
Itapuí;2017;4170;2342;1828;3522901
Itapura;2013;600;316;284;3523008
Itapura;2014;611;303;308;3523008
Itapura;2015;645;329;316;3523008
Itapura;2016;584;297;287;3523008
Itapura;2017;591;320;271;3523008
Itaquaquecetuba;2013;46464;28290;18174;3523107
Itaquaquecetuba;2014;45323;26535;18788;3523107
Itaquaquecetuba;2015;44789;25663;19126;3523107
Itaquaquecetuba;2016;39699;22865;16834;3523107
Itaquaquecetuba;2017;40879;23429;17450;3523107
Itararé;2013;8814;5276;3538;3523206
Itararé;2014;9073;5367;3706;3523206
Itararé;2015;8673;5100;3573;3523206
Itararé;2016;8588;5005;3583;3523206
Itararé;2017;8543;4994;3549;3523206
Itariri;2013;1359;846;513;3523305
Itariri;2014;1480;902;578;3523305
Itariri;2015;1457;880;577;3523305
Itariri;2016;1449;859;590;3523305
Itariri;2017;1499;902;597;3523305
Itatiba;2013;37210;21099;16111;3523404
Itatiba;2014;36260;21445;14815;3523404
Itatiba;2015;35366;20699;14667;3523404
Itatiba;2016;32182;18724;13458;3523404
Itatiba;2017;32751;18857;13894;3523404
Itatinga;2013;3342;1968;1374;3523503
Itatinga;2014;3359;1963;1396;3523503
Itatinga;2015;3207;1857;1350;3523503
Itatinga;2016;2967;1754;1213;3523503
Itatinga;2017;3173;1924;1249;3523503
Itirapina;2013;4054;2261;1793;3523602
Itirapina;2014;3852;2185;1667;3523602
Itirapina;2015;4379;2695;1684;3523602
Itirapina;2016;3409;1915;1494;3523602
Itirapina;2017;5047;2118;2929;3523602
Itirapuã;2013;808;491;317;3523701
Itirapuã;2014;783;480;303;3523701
Itirapuã;2015;783;484;299;3523701
Itirapuã;2016;770;476;294;3523701
Itirapuã;2017;809;504;305;3523701
Itobi;2013;840;463;377;3523800
Itobi;2014;880;521;359;3523800
Itobi;2015;877;521;356;3523800
Itobi;2016;911;544;367;3523800
Itobi;2017;968;571;397;3523800
Itu;2013;59118;33691;25427;3523909
Itu;2014;59129;33353;25776;3523909
Itu;2015;54937;31125;23812;3523909
Itu;2016;52708;29705;23003;3523909
Itu;2017;54239;30532;23707;3523909
Itupeva;2013;23176;13779;9397;3524006
Itupeva;2014;23797;13840;9957;3524006
Itupeva;2015;24543;14569;9974;3524006
Itupeva;2016;23233;13973;9260;3524006
Itupeva;2017;25145;15388;9757;3524006
Ituverava;2013;8044;4383;3661;3524105
Ituverava;2014;8209;4197;4012;3524105
Ituverava;2015;7587;3730;3857;3524105
Ituverava;2016;7242;3521;3721;3524105
Ituverava;2017;7508;3614;3894;3524105
Jaborandi;2013;906;548;358;3524204
Jaborandi;2014;951;581;370;3524204
Jaborandi;2015;980;587;393;3524204
Jaborandi;2016;900;519;381;3524204
Jaborandi;2017;931;515;416;3524204
Jaboticabal;2013;23224;15141;8083;3524303
Jaboticabal;2014;23222;14928;8294;3524303
Jaboticabal;2015;22455;14431;8024;3524303
Jaboticabal;2016;21134;13197;7937;3524303
Jaboticabal;2017;20323;12595;7728;3524303
Jacareí;2013;46627;27153;19474;3524402
Jacareí;2014;48473;27957;20516;3524402
Jacareí;2015;48896;28278;20618;3524402
Jacareí;2016;48742;27874;20868;3524402
Jacareí;2017;47934;27364;20570;3524402
Jaci;2013;2856;1450;1406;3524501
Jaci;2014;2947;1555;1392;3524501
Jaci;2015;2550;1427;1123;3524501
Jaci;2016;2365;1284;1081;3524501
Jaci;2017;2396;1329;1067;3524501
Jacupiranga;2013;3574;2485;1087;3524600
Jacupiranga;2014;3372;2268;1104;3524600
Jacupiranga;2015;3432;2353;1079;3524600
Jacupiranga;2016;3474;2373;1101;3524600
Jacupiranga;2017;3456;2349;1107;3524600
Jaguariúna;2013;32306;18542;13764;3524709
Jaguariúna;2014;36282;20250;16032;3524709
Jaguariúna;2015;36874;20766;16108;3524709
Jaguariúna;2016;34027;19135;14892;3524709
Jaguariúna;2017;34384;19478;14906;3524709
Jales;2013;11083;6065;5018;3524808
Jales;2014;10720;5833;4887;3524808
Jales;2015;10836;5725;5111;3524808
Jales;2016;10781;5820;4961;3524808
Jales;2017;10980;5916;5064;3524808
Jambeiro;2013;3705;2793;912;3524907
Jambeiro;2014;3825;2929;896;3524907
Jambeiro;2015;2717;1931;786;3524907
Jambeiro;2016;2522;1782;740;3524907
Jambeiro;2017;2674;1883;791;3524907
Jandira;2013;20918;12809;8109;3525003
Jandira;2014;23511;14409;9102;3525003
Jandira;2015;19950;11637;8313;3525003
Jandira;2016;19374;11390;7984;3525003
Jandira;2017;18729;10980;7749;3525003
Jardinópolis;2013;9223;5620;3603;3525102
Jardinópolis;2014;8347;4746;3601;3525102
Jardinópolis;2015;8753;4966;3787;3525102
Jardinópolis;2016;8597;4740;3857;3525102
Jardinópolis;2017;8777;4765;4012;3525102
Jarinu;2013;6855;3835;3020;3525201
Jarinu;2014;7379;4235;3144;3525201
Jarinu;2015;7383;4220;3163;3525201
Jarinu;2016;7892;4566;3326;3525201
Jarinu;2017;8227;4627;3600;3525201
Jaú;2013;39990;22130;17860;3525300
Jaú;2014;42481;23071;19410;3525300
Jaú;2015;39081;21523;17558;3525300
Jaú;2016;38723;21346;17377;3525300
Jaú;2017;41032;23301;17731;3525300
Jeriquara;2013;654;377;277;3525409
Jeriquara;2014;670;381;289;3525409
Jeriquara;2015;698;406;292;3525409
Jeriquara;2016;770;472;298;3525409
Jeriquara;2017;762;465;297;3525409
Joanópolis;2013;2040;1015;1025;3525508
Joanópolis;2014;2246;1140;1106;3525508
Joanópolis;2015;2285;1201;1084;3525508
Joanópolis;2016;2272;1214;1058;3525508
Joanópolis;2017;2332;1229;1103;3525508
João Ramalho;2013;489;268;221;3525607
João Ramalho;2014;519;288;231;3525607
João Ramalho;2015;425;219;206;3525607
João Ramalho;2016;516;282;234;3525607
João Ramalho;2017;456;242;214;3525607
José Bonifácio;2013;10280;6433;3847;3525706
José Bonifácio;2014;9799;6011;3788;3525706
José Bonifácio;2015;9996;6344;3652;3525706
José Bonifácio;2016;9892;6275;3617;3525706
José Bonifácio;2017;10083;6327;3756;3525706
Júlio Mesquita;2013;292;170;122;3525805
Júlio Mesquita;2014;545;289;256;3525805
Júlio Mesquita;2015;573;302;271;3525805
Júlio Mesquita;2016;554;274;280;3525805
Júlio Mesquita;2017;539;272;267;3525805
Jumirim;2013;1029;716;313;3525854
Jumirim;2014;978;677;301;3525854
Jumirim;2015;1232;855;377;3525854
Jumirim;2016;1077;752;325;3525854
Jumirim;2017;1217;838;379;3525854
Jundiaí;2013;181170;99526;81644;3525904
Jundiaí;2014;181692;100353;81339;3525904
Jundiaí;2015;172995;95650;77345;3525904
Jundiaí;2016;165924;90404;75520;3525904
Jundiaí;2017;162980;89720;73260;3525904
Junqueirópolis;2013;5441;3802;1639;3526001
Junqueirópolis;2014;5622;3861;1761;3526001
Junqueirópolis;2015;6038;4255;1783;3526001
Junqueirópolis;2016;5272;3651;1621;3526001
Junqueirópolis;2017;5315;3713;1602;3526001
Juquiá;2013;2397;1460;937;3526100
Juquiá;2014;2361;1428;933;3526100
Juquiá;2015;2410;1434;976;3526100
Juquiá;2016;2373;1415;958;3526100
Juquiá;2017;2376;1384;992;3526100
Juquitiba;2013;4061;2215;1846;3526209
Juquitiba;2014;4249;2109;2140;3526209
Juquitiba;2015;3752;1940;1812;3526209
Juquitiba;2016;5755;2065;3690;3526209
Juquitiba;2017;4431;2014;2417;3526209
Lagoinha;2013;719;475;244;3526308
Lagoinha;2014;724;477;247;3526308
Lagoinha;2015;747;475;272;3526308
Lagoinha;2016;705;452;253;3526308
Lagoinha;2017;715;454;261;3526308
Laranjal Paulista;2013;8559;4681;3878;3526407
Laranjal Paulista;2014;8486;4593;3893;3526407
Laranjal Paulista;2015;8685;4743;3942;3526407
Laranjal Paulista;2016;8832;4928;3904;3526407
Laranjal Paulista;2017;9093;5113;3980;3526407
Lavínia;2013;849;419;430;3526506
Lavínia;2014;788;396;392;3526506
Lavínia;2015;738;410;328;3526506
Lavínia;2016;822;404;418;3526506
Lavínia;2017;686;382;304;3526506
Lavrinhas;2013;778;447;331;3526605
Lavrinhas;2014;805;457;348;3526605
Lavrinhas;2015;817;477;340;3526605
Lavrinhas;2016;764;456;308;3526605
Lavrinhas;2017;787;448;339;3526605
Leme;2013;23741;13826;9915;3526704
Leme;2014;23627;13745;9882;3526704
Leme;2015;23014;13452;9562;3526704
Leme;2016;22086;12764;9322;3526704
Leme;2017;22244;12751;9493;3526704
Lençóis Paulista;2013;20875;13324;7551;3526803
Lençóis Paulista;2014;20288;12635;7653;3526803
Lençóis Paulista;2015;19775;12405;7370;3526803
Lençóis Paulista;2016;18513;11765;6748;3526803
Lençóis Paulista;2017;19390;12220;7170;3526803
Limeira;2013;89750;51644;38106;3526902
Limeira;2014;88567;50819;37748;3526902
Limeira;2015;83509;47074;36435;3526902
Limeira;2016;81255;46077;35178;3526902
Limeira;2017;81141;46098;35043;3526902
Lindóia;2013;1938;1101;837;3527009
Lindóia;2014;2082;1207;875;3527009
Lindóia;2015;2069;1209;860;3527009
Lindóia;2016;2022;1168;854;3527009
Lindóia;2017;1975;1181;794;3527009
Lins;2013;27261;16478;10783;3527108
Lins;2014;25899;15395;10504;3527108
Lins;2015;24826;14726;10100;3527108
Lins;2016;25154;14761;10393;3527108
Lins;2017;24032;14218;9814;3527108
Lorena;2013;16776;9745;7031;3527207
Lorena;2014;17740;10365;7375;3527207
Lorena;2015;17414;10061;7353;3527207
Lorena;2016;17240;9926;7314;3527207
Lorena;2017;17261;9832;7429;3527207
Lourdes;2013;282;124;158;3527256
Lourdes;2014;283;119;164;3527256
Lourdes;2015;278;111;167;3527256
Lourdes;2016;265;102;163;3527256
Lourdes;2017;248;94;154;3527256
Louveira;2013;18944;10868;8076;3527306
Louveira;2014;17877;10108;7769;3527306
Louveira;2015;17747;10351;7396;3527306
Louveira;2016;16730;9982;6748;3527306
Louveira;2017;16166;9578;6588;3527306
Lucélia;2013;7813;2462;5351;3527405
Lucélia;2014;8558;2804;5754;3527405
Lucélia;2015;8691;3195;5496;3527405
Lucélia;2016;8196;2724;5472;3527405
Lucélia;2017;7934;2722;5212;3527405
Lucianópolis;2013;870;631;239;3527504
Lucianópolis;2014;821;604;217;3527504
Lucianópolis;2015;880;646;234;3527504
Lucianópolis;2016;684;481;203;3527504
Lucianópolis;2017;932;694;238;3527504
Luís Antônio;2013;5008;4082;926;3527603
Luís Antônio;2014;5046;3868;1178;3527603
Luís Antônio;2015;5339;3962;1377;3527603
Luís Antônio;2016;5413;4207;1206;3527603
Luís Antônio;2017;6443;4902;1541;3527603
Luiziânia;2013;540;323;217;3527702
Luiziânia;2014;661;399;262;3527702
Luiziânia;2015;460;226;234;3527702
Luiziânia;2016;446;224;222;3527702
Luiziânia;2017;443;232;211;3527702
Lupércio;2013;683;454;229;3527801
Lupércio;2014;617;399;218;3527801
Lupércio;2015;555;359;196;3527801
Lupércio;2016;487;295;192;3527801
Lupércio;2017;637;433;204;3527801
Lutécia;2013;403;235;168;3527900
Lutécia;2014;447;274;173;3527900
Lutécia;2015;440;270;170;3527900
Lutécia;2016;441;257;184;3527900
Lutécia;2017;445;259;186;3527900
Macatuba;2013;4410;2644;1766;3528007
Macatuba;2014;4347;2639;1708;3528007
Macatuba;2015;4368;2661;1707;3528007
Macatuba;2016;4136;2453;1683;3528007
Macatuba;2017;3974;2389;1585;3528007
Macaubal;2013;2448;1269;1179;3528106
Macaubal;2014;2057;1043;1014;3528106
Macaubal;2015;1758;936;822;3528106
Macaubal;2016;1645;842;803;3528106
Macaubal;2017;1747;970;777;3528106
Macedônia;2013;493;314;179;3528205
Macedônia;2014;490;322;168;3528205
Macedônia;2015;485;313;172;3528205
Macedônia;2016;465;295;170;3528205
Macedônia;2017;452;276;176;3528205
Magda;2013;603;397;206;3528304
Magda;2014;570;379;191;3528304
Magda;2015;620;400;220;3528304
Magda;2016;637;412;225;3528304
Magda;2017;667;399;268;3528304
Mairinque;2013;9578;5303;4275;3528403
Mairinque;2014;9376;5182;4194;3528403
Mairinque;2015;9097;4878;4219;3528403
Mairinque;2016;9216;4822;4394;3528403
Mairinque;2017;9562;4935;4627;3528403
Mairiporã;2013;14716;8677;6039;3528502
Mairiporã;2014;14266;8312;5954;3528502
Mairiporã;2015;13367;7665;5702;3528502
Mairiporã;2016;13376;7702;5674;3528502
Mairiporã;2017;13578;7752;5826;3528502
Manduri;2013;1808;1082;726;3528601
Manduri;2014;1407;932;475;3528601
Manduri;2015;1769;1081;688;3528601
Manduri;2016;1698;1032;666;3528601
Manduri;2017;1440;858;582;3528601
Marabá Paulista;2013;711;449;262;3528700
Marabá Paulista;2014;677;414;263;3528700
Marabá Paulista;2015;678;424;254;3528700
Marabá Paulista;2016;664;406;258;3528700
Marabá Paulista;2017;649;394;255;3528700
Maracaí;2013;2555;1583;972;3528809
Maracaí;2014;2023;1192;831;3528809
Maracaí;2015;2418;1485;933;3528809
Maracaí;2016;2605;1543;1062;3528809
Maracaí;2017;2696;1764;932;3528809
Marapoama;2013;1444;1135;309;3528858
Marapoama;2014;1407;1080;327;3528858
Marapoama;2015;1426;1083;343;3528858
Marapoama;2016;1496;1154;342;3528858
Marapoama;2017;1478;1113;365;3528858
Mariápolis;2013;353;187;166;3528908
Mariápolis;2014;367;191;176;3528908
Mariápolis;2015;353;182;171;3528908
Mariápolis;2016;328;170;158;3528908
Mariápolis;2017;331;169;162;3528908
Marília;2013;64346;35529;28817;3529005
Marília;2014;65792;35723;30069;3529005
Marília;2015;65282;35040;30242;3529005
Marília;2016;66320;35477;30843;3529005
Marília;2017;66947;35490;31457;3529005
Marinópolis;2013;319;175;144;3529104
Marinópolis;2014;325;179;146;3529104
Marinópolis;2015;324;186;138;3529104
Marinópolis;2016;336;189;147;3529104
Marinópolis;2017;315;173;142;3529104
Martinópolis;2013;3494;2094;1400;3529203
Martinópolis;2014;3365;1865;1500;3529203
Martinópolis;2015;3442;1914;1528;3529203
Martinópolis;2016;2985;1596;1389;3529203
Martinópolis;2017;2931;1525;1406;3529203
Matão;2013;32407;20646;11761;3529302
Matão;2014;30916;19466;11450;3529302
Matão;2015;33424;21650;11774;3529302
Matão;2016;30315;19279;11036;3529302
Matão;2017;32368;20816;11552;3529302
Mauá;2013;73131;43588;29543;3529401
Mauá;2014;66979;40911;26068;3529401
Mauá;2015;66174;39803;26371;3529401
Mauá;2016;64480;38990;25490;3529401
Mauá;2017;63968;38502;25466;3529401
Mendonça;2013;2151;1627;524;3529500
Mendonça;2014;2437;1834;603;3529500
Mendonça;2015;1338;825;513;3529500
Mendonça;2016;2310;1733;577;3529500
Mendonça;2017;2429;1835;594;3529500
Meridiano;2013;2408;2003;405;3529609
Meridiano;2014;2549;2096;453;3529609
Meridiano;2015;2382;1921;461;3529609
Meridiano;2016;2169;1767;402;3529609
Meridiano;2017;2142;1715;427;3529609
Mesópolis;2013;240;111;129;3529658
Mesópolis;2014;223;105;118;3529658
Mesópolis;2015;219;104;115;3529658
Mesópolis;2016;227;109;118;3529658
Mesópolis;2017;251;116;135;3529658
Miguelópolis;2013;4292;2732;1560;3529708
Miguelópolis;2014;4351;2659;1692;3529708
Miguelópolis;2015;3451;1792;1659;3529708
Miguelópolis;2016;2735;1266;1469;3529708
Miguelópolis;2017;2713;1233;1480;3529708
Mineiros do Tietê;2013;1722;971;751;3529807
Mineiros do Tietê;2014;1847;1096;751;3529807
Mineiros do Tietê;2015;1589;880;709;3529807
Mineiros do Tietê;2016;1450;828;622;3529807
Mineiros do Tietê;2017;1536;869;667;3529807
Mira Estrela;2013;457;242;215;3530003
Mira Estrela;2014;458;236;222;3530003
Mira Estrela;2015;487;258;229;3530003
Mira Estrela;2016;488;255;233;3530003
Mira Estrela;2017;452;242;210;3530003
Miracatu;2013;2793;1791;1002;3529906
Miracatu;2014;2902;1757;1145;3529906
Miracatu;2015;2942;1707;1235;3529906
Miracatu;2016;3106;1807;1299;3529906
Miracatu;2017;2718;1591;1127;3529906
Mirandópolis;2013;4302;2488;1814;3530102
Mirandópolis;2014;4258;2399;1859;3530102
Mirandópolis;2015;3942;2220;1722;3530102
Mirandópolis;2016;3836;2155;1681;3530102
Mirandópolis;2017;3848;2207;1641;3530102
Mirante do Paranapanema;2013;3736;2760;976;3530201
Mirante do Paranapanema;2014;3713;2772;941;3530201
Mirante do Paranapanema;2015;3700;2676;1024;3530201
Mirante do Paranapanema;2016;3502;2527;975;3530201
Mirante do Paranapanema;2017;3633;2603;1030;3530201
Mirassol;2013;14767;9100;5667;3530300
Mirassol;2014;15136;9419;5717;3530300
Mirassol;2015;14058;8481;5577;3530300
Mirassol;2016;13298;8014;5284;3530300
Mirassol;2017;13731;8327;5404;3530300
Mirassolândia;2013;543;317;226;3530409
Mirassolândia;2014;583;329;254;3530409
Mirassolândia;2015;551;359;192;3530409
Mirassolândia;2016;568;384;184;3530409
Mirassolândia;2017;565;372;193;3530409
Mococa;2013;17731;11328;6403;3530508
Mococa;2014;17582;11058;6524;3530508
Mococa;2015;17029;10829;6200;3530508
Mococa;2016;16470;10415;6055;3530508
Mococa;2017;16757;10802;5955;3530508
Mogi das Cruzes;2013;101402;56392;45010;3530607
Mogi das Cruzes;2014;104185;57450;46735;3530607
Mogi das Cruzes;2015;100987;55074;45913;3530607
Mogi das Cruzes;2016;98273;54033;44240;3530607
Mogi das Cruzes;2017;99614;54820;44794;3530607
Mogi Guaçu;2013;40766;24071;16695;3530706
Mogi Guaçu;2014;40905;24099;16806;3530706
Mogi Guaçu;2015;41680;23835;17845;3530706
Mogi Guaçu;2016;37809;22125;15684;3530706
Mogi Guaçu;2017;39210;22895;16315;3530706
Mogi Mirim;2013;29371;17425;11946;
Mogi Mirim;2014;29326;17203;12123;
Mogi Mirim;2015;28367;16504;11863;
Mogi Mirim;2016;27216;15793;11423;
Mogi Mirim;2017;27594;16072;11522;
Mombuca;2013;491;265;226;3530904
Mombuca;2014;535;305;230;3530904
Mombuca;2015;592;346;246;3530904
Mombuca;2016;603;371;232;3530904
Mombuca;2017;711;413;298;3530904
Mongaguá;2013;5919;2958;2961;3531100
Mongaguá;2014;6032;3107;2925;3531100
Mongaguá;2015;6574;3445;3129;3531100
Mongaguá;2016;6134;3204;2930;3531100
Mongaguá;2017;6189;3291;2898;3531100
Monte Alegre do Sul;2013;1405;747;658;3531209
Monte Alegre do Sul;2014;1127;642;485;3531209
Monte Alegre do Sul;2015;1162;649;513;3531209
Monte Alegre do Sul;2016;1089;614;475;3531209
Monte Alegre do Sul;2017;1194;688;506;3531209
Monte Alto;2013;14343;8586;5757;3531308
Monte Alto;2014;13704;8075;5629;3531308
Monte Alto;2015;13130;7605;5525;3531308
Monte Alto;2016;12874;7515;5359;3531308
Monte Alto;2017;12925;7522;5403;3531308
Monte Aprazível;2013;4212;2500;1712;3531407
Monte Aprazível;2014;5535;3826;1709;3531407
Monte Aprazível;2015;5850;4145;1705;3531407
Monte Aprazível;2016;6135;4498;1637;3531407
Monte Aprazível;2017;4182;2615;1567;3531407
Monte Azul Paulista;2013;5963;3961;2002;3531506
Monte Azul Paulista;2014;5084;3277;1807;3531506
Monte Azul Paulista;2015;4742;3037;1705;3531506
Monte Azul Paulista;2016;4045;2503;1542;3531506
Monte Azul Paulista;2017;5467;3725;1742;3531506
Monte Castelo;2013;581;267;314;3531605
Monte Castelo;2014;534;239;295;3531605
Monte Castelo;2015;606;300;306;3531605
Monte Castelo;2016;499;247;252;3531605
Monte Castelo;2017;507;263;244;3531605
Monte Mor;2013;11246;7069;4177;3531803
Monte Mor;2014;13389;8707;4682;3531803
Monte Mor;2015;13220;8442;4778;3531803
Monte Mor;2016;13161;8332;4829;3531803
Monte Mor;2017;14259;8779;5480;3531803
Monteiro Lobato;2013;856;532;324;3531704
Monteiro Lobato;2014;1048;689;359;3531704
Monteiro Lobato;2015;676;403;273;3531704
Monteiro Lobato;2016;675;410;265;3531704
Monteiro Lobato;2017;664;414;250;3531704
Monções;2013;1798;1578;220;3531001
Monções;2014;1417;1229;188;3531001
Monções;2015;1564;1340;224;3531001
Monções;2016;1751;1528;223;3531001
Monções;2017;1679;1429;250;3531001
Morro Agudo;2013;8168;5689;2479;3531902
Morro Agudo;2014;8392;5927;2465;3531902
Morro Agudo;2015;9079;6610;2469;3531902
Morro Agudo;2016;8785;6408;2377;3531902
Morro Agudo;2017;8200;5846;2354;3531902
Morungaba;2013;11314;5205;6109;3532009
Morungaba;2014;9869;4519;5350;3532009
Morungaba;2015;8210;3917;4293;3532009
Morungaba;2016;6058;2381;3677;3532009
Morungaba;2017;5462;2196;3266;3532009
Motuca;2013;523;251;272;3532058
Motuca;2014;539;266;273;3532058
Motuca;2015;591;306;285;3532058
Motuca;2016;627;342;285;3532058
Motuca;2017;639;360;279;3532058
Murutinga do Sul;2013;486;254;232;3532108
Murutinga do Sul;2014;511;270;241;3532108
Murutinga do Sul;2015;495;258;237;3532108
Murutinga do Sul;2016;524;286;238;3532108
Murutinga do Sul;2017;478;250;228;3532108
Nantes;2013;352;207;145;3532157
Nantes;2014;342;200;142;3532157
Nantes;2015;367;214;153;3532157
Nantes;2016;324;194;130;3532157
Nantes;2017;369;222;147;3532157
Narandiba;2013;1045;654;391;3532207
Narandiba;2014;1050;654;396;3532207
Narandiba;2015;1033;655;378;3532207
Narandiba;2016;1040;666;374;3532207
Narandiba;2017;1059;679;380;3532207
Natividade da Serra;2013;704;473;231;3532306
Natividade da Serra;2014;753;522;231;3532306
Natividade da Serra;2015;787;518;269;3532306
Natividade da Serra;2016;716;486;230;3532306
Natividade da Serra;2017;694;471;223;3532306
Nazaré Paulista;2013;2887;1862;1025;3532405
Nazaré Paulista;2014;2778;1686;1092;3532405
Nazaré Paulista;2015;2805;1682;1123;3532405
Nazaré Paulista;2016;2712;1607;1105;3532405
Nazaré Paulista;2017;2885;1784;1101;3532405
Neves Paulista;2013;1620;959;661;3532504
Neves Paulista;2014;1618;961;657;3532504
Neves Paulista;2015;1584;922;662;3532504
Neves Paulista;2016;1679;1058;621;3532504
Neves Paulista;2017;1916;1162;754;3532504
Nhandeara;2013;1850;1042;808;3532603
Nhandeara;2014;1935;1068;867;3532603
Nhandeara;2015;1849;1002;847;3532603
Nhandeara;2016;1778;929;849;3532603
Nhandeara;2017;1703;878;825;3532603
Nipoã;2013;627;358;269;3532702
Nipoã;2014;743;420;323;3532702
Nipoã;2015;774;450;324;3532702
Nipoã;2016;757;449;308;3532702
Nipoã;2017;819;493;326;3532702
Nova Aliança;2013;1138;657;481;3532801
Nova Aliança;2014;1185;689;496;3532801
Nova Aliança;2015;1205;685;520;3532801
Nova Aliança;2016;1244;707;537;3532801
Nova Aliança;2017;1352;778;574;3532801
Nova Campina;2013;2340;1679;661;3532827
Nova Campina;2014;2072;1494;578;3532827
Nova Campina;2015;2246;1634;612;3532827
Nova Campina;2016;1908;1417;491;3532827
Nova Campina;2017;1956;1458;498;3532827
Nova Canaã Paulista;2013;213;103;110;3532843
Nova Canaã Paulista;2014;255;145;110;3532843
Nova Canaã Paulista;2015;214;106;108;3532843
Nova Canaã Paulista;2016;214;106;108;3532843
Nova Canaã Paulista;2017;202;105;97;3532843
Nova Castilho;2013;240;144;96;3532868
Nova Castilho;2014;224;136;88;3532868
Nova Castilho;2015;235;143;92;3532868
Nova Castilho;2016;236;143;93;3532868
Nova Castilho;2017;219;139;80;3532868
Nova Europa;2013;3946;3071;875;3532900
Nova Europa;2014;4035;3245;790;3532900
Nova Europa;2015;4039;3205;834;3532900
Nova Europa;2016;3786;3046;740;3532900
Nova Europa;2017;3586;2800;786;3532900
Nova Granada;2013;2565;1369;1196;3533007
Nova Granada;2014;2560;1330;1230;3533007
Nova Granada;2015;2554;1384;1170;3533007
Nova Granada;2016;2608;1374;1234;3533007
Nova Granada;2017;2960;1647;1313;3533007
Nova Guataporanga;2013;253;145;108;3533106
Nova Guataporanga;2014;231;125;106;3533106
Nova Guataporanga;2015;236;129;107;3533106
Nova Guataporanga;2016;225;122;103;3533106
Nova Guataporanga;2017;256;135;121;3533106
Nova Independência;2013;1390;1044;346;3533205
Nova Independência;2014;1393;1047;346;3533205
Nova Independência;2015;1298;988;310;3533205
Nova Independência;2016;1342;1037;305;3533205
Nova Independência;2017;1546;1218;328;3533205
Nova Luzitânia;2013;353;179;174;3533304
Nova Luzitânia;2014;323;152;171;3533304
Nova Luzitânia;2015;277;132;145;3533304
Nova Luzitânia;2016;269;122;147;3533304
Nova Luzitânia;2017;278;131;147;3533304
Nova Odessa;2013;19748;12461;7287;3533403
Nova Odessa;2014;19459;12044;7415;3533403
Nova Odessa;2015;18446;11471;6975;3533403
Nova Odessa;2016;18115;11224;6891;3533403
Nova Odessa;2017;18963;11767;7196;3533403
Novais;2013;351;162;189;3533254
Novais;2014;438;174;264;3533254
Novais;2015;428;181;247;3533254
Novais;2016;427;178;249;3533254
Novais;2017;457;208;249;3533254
Novo Horizonte;2013;9896;6491;3405;3533502
Novo Horizonte;2014;8688;5519;3169;3533502
Novo Horizonte;2015;10702;7284;3418;3533502
Novo Horizonte;2016;9744;6367;3377;3533502
Novo Horizonte;2017;9751;6372;3379;3533502
Nuporanga;2013;2810;1246;1564;3533601
Nuporanga;2014;2991;1391;1600;3533601
Nuporanga;2015;3064;1435;1629;3533601
Nuporanga;2016;3005;1412;1593;3533601
Nuporanga;2017;3170;1479;1691;3533601
Ocauçu;2013;740;471;269;3533700
Ocauçu;2014;817;500;317;3533700
Ocauçu;2015;859;548;311;3533700
Ocauçu;2016;902;575;327;3533700
Ocauçu;2017;969;641;328;3533700
Óleo;2013;361;232;129;3533809
Óleo;2014;361;227;134;3533809
Óleo;2015;364;240;124;3533809
Óleo;2016;332;213;119;3533809
Óleo;2017;333;209;124;3533809
Olímpia;2013;14856;9334;5522;3533908
Olímpia;2014;15361;9545;5816;3533908
Olímpia;2015;15395;9381;6014;3533908
Olímpia;2016;15019;9108;5911;3533908
Olímpia;2017;15075;9100;5975;3533908
Onda Verde;2013;3366;2708;658;3534005
Onda Verde;2014;2290;1661;629;3534005
Onda Verde;2015;2681;2006;675;3534005
Onda Verde;2016;2333;1709;624;3534005
Onda Verde;2017;2269;1697;572;3534005
Oriente;2013;961;639;322;3534104
Oriente;2014;912;588;324;3534104
Oriente;2015;951;605;346;3534104
Oriente;2016;807;476;331;3534104
Oriente;2017;849;514;335;3534104
Orindiúva;2013;3135;2481;654;3534203
Orindiúva;2014;2991;2356;635;3534203
Orindiúva;2015;2880;2248;632;3534203
Orindiúva;2016;2908;2301;607;3534203
Orindiúva;2017;2876;2256;620;3534203
Orlândia;2013;11917;7942;3975;3534302
Orlândia;2014;11931;7854;4077;3534302
Orlândia;2015;11493;7529;3964;3534302
Orlândia;2016;11386;7433;3953;3534302
Orlândia;2017;11538;7567;3971;3534302
Osasco;2013;175612;99514;76098;3534401
Osasco;2014;177201;99176;78025;3534401
Osasco;2015;169369;94420;74949;3534401
Osasco;2016;160186;87716;72470;3534401
Osasco;2017;155192;85411;69781;3534401
Oscar Bressane;2013;434;232;202;3534500
Oscar Bressane;2014;433;235;198;3534500
Oscar Bressane;2015;442;250;192;3534500
Oscar Bressane;2016;452;247;205;3534500
Oscar Bressane;2017;454;249;205;3534500
Osvaldo Cruz;2013;7771;4265;3506;3534609
Osvaldo Cruz;2014;7911;4318;3593;3534609
Osvaldo Cruz;2015;7754;4227;3527;3534609
Osvaldo Cruz;2016;7362;3927;3435;3534609
Osvaldo Cruz;2017;7367;3976;3391;3534609
Ourinhos;2013;27843;16447;11396;3534708
Ourinhos;2014;28006;16347;11659;3534708
Ourinhos;2015;27383;15894;11489;3534708
Ourinhos;2016;26600;15359;11241;3534708
Ourinhos;2017;26636;15455;11181;3534708
Ouro Verde;2013;681;390;291;3534807
Ouro Verde;2014;678;367;311;3534807
Ouro Verde;2015;771;458;313;3534807
Ouro Verde;2016;748;435;313;3534807
Ouro Verde;2017;765;439;326;3534807
Ouroeste;2013;3231;2255;976;3534757
Ouroeste;2014;3107;2127;980;3534757
Ouroeste;2015;2778;1935;843;3534757
Ouroeste;2016;2805;1998;807;3534757
Ouroeste;2017;2897;2155;742;3534757
Pacaembu;2013;1424;760;664;3534906
Pacaembu;2014;1469;808;661;3534906
Pacaembu;2015;1494;811;683;3534906
Pacaembu;2016;1461;745;716;3534906
Pacaembu;2017;1502;776;726;3534906
Palestina;2013;2750;2035;715;3535002
Palestina;2014;2871;2090;781;3535002
Palestina;2015;2717;1963;754;3535002
Palestina;2016;2580;1879;701;3535002
Palestina;2017;2548;1797;751;3535002
Palmares Paulista;2013;802;333;469;3535101
Palmares Paulista;2014;804;333;471;3535101
Palmares Paulista;2015;779;325;454;3535101
Palmares Paulista;2016;784;334;450;3535101
Palmares Paulista;2017;776;317;459;3535101
Palmeira d'Oeste;2013;1027;554;473;3535200
Palmeira d'Oeste;2014;1099;612;487;3535200
Palmeira d'Oeste;2015;1076;637;439;3535200
Palmeira d'Oeste;2016;1174;698;476;3535200
Palmeira d'Oeste;2017;1071;650;421;3535200
Palmital;2013;3808;2338;1470;3535309
Palmital;2014;3828;2278;1550;3535309
Palmital;2015;3816;2308;1508;3535309
Palmital;2016;3823;2362;1461;3535309
Palmital;2017;4039;2567;1472;3535309
Panorama;2013;2960;2004;956;3535408
Panorama;2014;3003;1944;1059;3535408
Panorama;2015;2904;1872;1032;3535408
Panorama;2016;2920;1882;1038;3535408
Panorama;2017;2776;1783;993;3535408
Paraguaçu Paulista;2013;14809;10253;4556;3535507
Paraguaçu Paulista;2014;14061;9619;4442;3535507
Paraguaçu Paulista;2015;12873;8899;3974;3535507
Paraguaçu Paulista;2016;12689;8905;3784;3535507
Paraguaçu Paulista;2017;12671;8990;3681;3535507
Paraibuna;2013;2695;1358;1337;3535606
Paraibuna;2014;2728;1387;1341;3535606
Paraibuna;2015;3021;1637;1384;3535606
Paraibuna;2016;2731;1464;1267;3535606
Paraibuna;2017;2734;1554;1180;3535606
Paraíso;2013;2356;1717;639;3535705
Paraíso;2014;2134;1581;553;3535705
Paraíso;2015;1772;1284;488;3535705
Paraíso;2016;2147;1511;636;3535705
Paraíso;2017;1968;1444;524;3535705
Paranapanema;2013;4497;2633;1864;3535804
Paranapanema;2014;4763;2688;2075;3535804
Paranapanema;2015;4494;2569;1925;3535804
Paranapanema;2016;4832;2714;2118;3535804
Paranapanema;2017;4607;2613;1994;3535804
Paranapuã;2013;600;332;268;3535903
Paranapuã;2014;633;363;270;3535903
Paranapuã;2015;651;363;288;3535903
Paranapuã;2016;688;386;302;3535903
Paranapuã;2017;734;447;287;3535903
Parapuã;2013;3380;2680;700;3536000
Parapuã;2014;3135;2365;770;3536000
Parapuã;2015;2986;2235;751;3536000
Parapuã;2016;2803;2050;753;3536000
Parapuã;2017;2928;2151;777;3536000
Pardinho;2013;2228;1278;950;3536109
Pardinho;2014;2276;1331;945;3536109
Pardinho;2015;2451;1400;1051;3536109
Pardinho;2016;2367;1322;1045;3536109
Pardinho;2017;2198;1206;992;3536109
Pariquera-Açu;2013;4257;2575;1682;3536208
Pariquera-Açu;2014;4780;2643;2137;3536208
Pariquera-Açu;2015;4613;2442;2171;3536208
Pariquera-Açu;2016;4623;2488;2135;3536208
Pariquera-Açu;2017;4427;2373;2054;3536208
Parisi;2013;320;191;129;3536257
Parisi;2014;287;167;120;3536257
Parisi;2015;292;171;121;3536257
Parisi;2016;293;168;125;3536257
Parisi;2017;314;183;131;3536257
Patrocínio Paulista;2013;3985;2915;1070;3536307
Patrocínio Paulista;2014;4107;3029;1078;3536307
Patrocínio Paulista;2015;4181;3022;1159;3536307
Patrocínio Paulista;2016;4071;3090;981;3536307
Patrocínio Paulista;2017;4243;3151;1092;3536307
Paulicéia;2013;2314;1691;623;3536406
Paulicéia;2014;2124;1511;613;3536406
Paulicéia;2015;2138;1531;607;3536406
Paulicéia;2016;2031;1449;582;3536406
Paulicéia;2017;1907;1349;558;3536406
Paulínia;2013;43256;28016;15240;3536505
Paulínia;2014;40025;25544;14481;3536505
Paulínia;2015;43876;28175;15701;3536505
Paulínia;2016;40881;26359;14522;3536505
Paulínia;2017;40792;26663;14129;3536505
Paulistânia;2013;241;145;96;3536570
Paulistânia;2014;258;152;106;3536570
Paulistânia;2015;297;185;112;3536570
Paulistânia;2016;307;193;114;3536570
Paulistânia;2017;315;186;129;3536570
Paulo de Faria;2013;911;452;459;3536604
Paulo de Faria;2014;1072;580;492;3536604
Paulo de Faria;2015;1046;584;462;3536604
Paulo de Faria;2016;1060;577;483;3536604
Paulo de Faria;2017;1071;606;465;3536604
Pederneiras;2013;14144;9766;4378;3536703
Pederneiras;2014;13627;9117;4510;3536703
Pederneiras;2015;12132;7781;4351;3536703
Pederneiras;2016;12224;7847;4377;3536703
Pederneiras;2017;12650;8177;4473;3536703
Pedra Bela;2013;755;420;335;3536802
Pedra Bela;2014;821;471;350;3536802
Pedra Bela;2015;842;481;361;3536802
Pedra Bela;2016;815;455;360;3536802
Pedra Bela;2017;845;457;388;3536802
Pedranópolis;2013;400;249;151;3536901
Pedranópolis;2014;413;245;168;3536901
Pedranópolis;2015;409;239;170;3536901
Pedranópolis;2016;388;241;147;3536901
Pedranópolis;2017;392;246;146;3536901
Pedregulho;2013;3450;1986;1464;3537008
Pedregulho;2014;3589;2126;1463;3537008
Pedregulho;2015;3317;1999;1318;3537008
Pedregulho;2016;3407;2042;1365;3537008
Pedregulho;2017;3328;1988;1340;3537008
Pedreira;2013;13534;7132;6402;3537107
Pedreira;2014;13528;7140;6388;3537107
Pedreira;2015;13134;7010;6124;3537107
Pedreira;2016;13042;6924;6118;3537107
Pedreira;2017;13137;7084;6053;3537107
Pedrinhas Paulista;2013;511;290;221;3537156
Pedrinhas Paulista;2014;543;305;238;3537156
Pedrinhas Paulista;2015;537;306;231;3537156
Pedrinhas Paulista;2016;509;294;215;3537156
Pedrinhas Paulista;2017;600;345;255;3537156
Pedro de Toledo;2013;1025;563;462;3537206
Pedro de Toledo;2014;1033;538;495;3537206
Pedro de Toledo;2015;1036;553;483;3537206
Pedro de Toledo;2016;1021;528;493;3537206
Pedro de Toledo;2017;968;504;464;3537206
Penápolis;2013;13780;7448;6332;3537305
Penápolis;2014;14777;7891;6886;3537305
Penápolis;2015;14790;7847;6943;3537305
Penápolis;2016;14850;7878;6972;3537305
Penápolis;2017;15077;7855;7222;3537305
Pereira Barreto;2013;6230;4068;2162;3537404
Pereira Barreto;2014;6048;3873;2175;3537404
Pereira Barreto;2015;5929;3809;2120;3537404
Pereira Barreto;2016;6049;3775;2274;3537404
Pereira Barreto;2017;5518;3563;1955;3537404
Pereiras;2013;2034;1312;722;3537503
Pereiras;2014;2049;1313;736;3537503
Pereiras;2015;1958;1188;770;3537503
Pereiras;2016;1982;1193;789;3537503
Pereiras;2017;2364;1473;891;3537503
Peruíbe;2013;8797;4491;4306;3537602
Peruíbe;2014;9077;4572;4505;3537602
Peruíbe;2015;9217;4730;4487;3537602
Peruíbe;2016;8938;4553;4385;3537602
Peruíbe;2017;9180;4614;4566;3537602
Piacatu;2013;968;429;539;3537701
Piacatu;2014;919;413;506;3537701
Piacatu;2015;994;442;552;3537701
Piacatu;2016;934;404;530;3537701
Piacatu;2017;916;393;523;3537701
Piedade;2013;8096;4690;3406;3537800
Piedade;2014;8401;4763;3638;3537800
Piedade;2015;8219;4628;3591;3537800
Piedade;2016;8203;4644;3559;3537800
Piedade;2017;8395;4815;3580;3537800
Pilar do Sul;2013;6886;4612;2274;3537909
Pilar do Sul;2014;6840;4600;2240;3537909
Pilar do Sul;2015;6870;4652;2218;3537909
Pilar do Sul;2016;6860;4661;2199;3537909
Pilar do Sul;2017;6849;4648;2201;3537909
Pindamonhangaba;2013;34051;22240;11811;3538006
Pindamonhangaba;2014;34048;21433;12615;3538006
Pindamonhangaba;2015;32564;20184;12380;3538006
Pindamonhangaba;2016;30148;18235;11913;3538006
Pindamonhangaba;2017;30020;17904;12116;3538006
Pindorama;2013;2577;1582;995;3538105
Pindorama;2014;2435;1458;977;3538105
Pindorama;2015;2387;1413;974;3538105
Pindorama;2016;2365;1424;941;3538105
Pindorama;2017;2451;1470;981;3538105
Pinhalzinho;2013;1951;982;969;3538204
Pinhalzinho;2014;2008;1048;960;3538204
Pinhalzinho;2015;2091;1088;1003;3538204
Pinhalzinho;2016;2067;1081;986;3538204
Pinhalzinho;2017;2093;1070;1023;3538204
Piquerobi;2013;602;356;246;3538303
Piquerobi;2014;621;355;266;3538303
Piquerobi;2015;596;362;234;3538303
Piquerobi;2016;548;328;220;3538303
Piquerobi;2017;563;334;229;3538303
Piquete;2013;1513;1011;502;3538501
Piquete;2014;1338;944;394;3538501
Piquete;2015;1338;910;428;3538501
Piquete;2016;1371;939;432;3538501
Piquete;2017;1336;915;421;3538501
Piracaia;2013;4389;2259;2130;3538600
Piracaia;2014;4251;2225;2026;3538600
Piracaia;2015;4308;2203;2105;3538600
Piracaia;2016;4185;2106;2079;3538600
Piracaia;2017;4043;2045;1998;3538600
Piracicaba;2013;134033;81692;52341;3538709
Piracicaba;2014;132407;78784;53623;3538709
Piracicaba;2015;125920;74135;51785;3538709
Piracicaba;2016;124650;73791;50859;3538709
Piracicaba;2017;122896;72516;50380;3538709
Piraju;2013;6318;3685;2633;3538808
Piraju;2014;6224;3559;2665;3538808
Piraju;2015;5962;3312;2650;3538808
Piraju;2016;6109;3507;2602;3538808
Piraju;2017;6021;3426;2595;3538808
Pirajuí;2013;3181;1872;1309;3538907
Pirajuí;2014;3301;1958;1343;3538907
Pirajuí;2015;3594;2053;1541;3538907
Pirajuí;2016;3257;1761;1496;3538907
Pirajuí;2017;3468;2011;1457;3538907
Pirangi;2013;2050;1132;918;3539004
Pirangi;2014;2148;1227;921;3539004
Pirangi;2015;2052;1142;910;3539004
Pirangi;2016;2153;1232;921;3539004
Pirangi;2017;2150;1236;914;3539004
Pirapora do Bom Jesus;2013;3134;1595;1539;3539103
Pirapora do Bom Jesus;2014;2686;1336;1350;3539103
Pirapora do Bom Jesus;2015;2397;1362;1035;3539103
Pirapora do Bom Jesus;2016;2020;1139;881;3539103
Pirapora do Bom Jesus;2017;2175;1191;984;3539103
Pirapozinho;2013;4931;2723;2208;3539202
Pirapozinho;2014;5051;2851;2200;3539202
Pirapozinho;2015;4885;2647;2238;3539202
Pirapozinho;2016;4714;2571;2143;3539202
Pirapozinho;2017;4794;2634;2160;3539202
Pirassununga;2013;21402;13309;8093;3539301
Pirassununga;2014;20879;12818;8061;3539301
Pirassununga;2015;20861;12795;8066;3539301
Pirassununga;2016;20603;12663;7940;3539301
Pirassununga;2017;23046;14241;8805;3539301
Piratininga;2013;1785;1022;763;3539400
Piratininga;2014;1827;995;832;3539400
Piratininga;2015;1977;1089;888;3539400
Piratininga;2016;1940;1019;921;3539400
Piratininga;2017;1962;1055;907;3539400
Pitangueiras;2013;7497;5301;2196;3539509
Pitangueiras;2014;8039;5531;2508;3539509
Pitangueiras;2015;7802;5397;2405;3539509
Pitangueiras;2016;7958;5507;2451;3539509
Pitangueiras;2017;7756;5345;2411;3539509
Planalto;2013;2857;2564;293;3539608
Planalto;2014;914;633;281;3539608
Planalto;2015;1051;745;306;3539608
Planalto;2016;1110;829;281;3539608
Planalto;2017;3063;2728;335;3539608
Platina;2013;595;409;186;3539707
Platina;2014;469;308;161;3539707
Platina;2015;516;335;181;3539707
Platina;2016;460;300;160;3539707
Platina;2017;473;311;162;3539707
Poá;2013;33916;17531;16385;3539806
Poá;2014;31692;15621;16071;3539806
Poá;2015;29940;14976;14964;3539806
Poá;2016;27571;13426;14145;3539806
Poá;2017;26701;13007;13694;3539806
Poloni;2013;936;526;410;3539905
Poloni;2014;973;545;428;3539905
Poloni;2015;985;569;416;3539905
Poloni;2016;946;556;390;3539905
Poloni;2017;1002;573;429;3539905
Pompéia;2013;7984;5349;2635;3540002
Pompéia;2014;7704;5040;2664;3540002
Pompéia;2015;7236;4644;2592;3540002
Pompéia;2016;7383;4810;2573;3540002
Pompéia;2017;7482;4827;2655;3540002
Pongaí;2013;494;273;221;3540101
Pongaí;2014;524;290;234;3540101
Pongaí;2015;499;276;223;3540101
Pongaí;2016;490;265;225;3540101
Pongaí;2017;561;337;224;3540101
Pontal;2013;10195;7406;2789;3540200
Pontal;2014;8494;5914;2580;3540200
Pontal;2015;9004;6437;2567;3540200
Pontal;2016;9103;6442;2661;3540200
Pontal;2017;9211;6588;2623;3540200
Pontalinda;2013;422;171;251;3540259
Pontalinda;2014;436;177;259;3540259
Pontalinda;2015;430;171;259;3540259
Pontalinda;2016;369;165;204;3540259
Pontalinda;2017;429;175;254;3540259
Pontes Gestal;2013;1846;1388;458;3540309
Pontes Gestal;2014;1562;1169;393;3540309
Pontes Gestal;2015;1479;1119;360;3540309
Pontes Gestal;2016;1441;1065;376;3540309
Pontes Gestal;2017;1375;1042;333;3540309
Populina;2013;388;190;198;3540408
Populina;2014;487;244;243;3540408
Populina;2015;479;232;247;3540408
Populina;2016;490;246;244;3540408
Populina;2017;527;300;227;3540408
Porangaba;2013;1249;749;500;3540507
Porangaba;2014;1430;862;568;3540507
Porangaba;2015;1302;794;508;3540507
Porangaba;2016;1381;856;525;3540507
Porangaba;2017;1402;837;565;3540507
Porto Feliz;2013;13641;7728;5913;3540606
Porto Feliz;2014;13610;7697;5913;3540606
Porto Feliz;2015;13729;7798;5931;3540606
Porto Feliz;2016;13892;7896;5996;3540606
Porto Feliz;2017;14350;8324;6026;3540606
Porto Ferreira;2013;15840;9011;6829;3540705
Porto Ferreira;2014;16298;9269;7029;3540705
Porto Ferreira;2015;15531;8942;6589;3540705
Porto Ferreira;2016;15036;8610;6426;3540705
Porto Ferreira;2017;15197;8680;6517;3540705
Potim;2013;1408;750;658;3540754
Potim;2014;1402;745;657;3540754
Potim;2015;1389;750;639;3540754
Potim;2016;1236;667;569;3540754
Potim;2017;1315;699;616;3540754
Potirendaba;2013;4887;3761;1126;3540804
Potirendaba;2014;5348;4017;1331;3540804
Potirendaba;2015;4579;3474;1105;3540804
Potirendaba;2016;4393;3228;1165;3540804
Potirendaba;2017;4386;3215;1171;3540804
Pracinha;2013;264;125;139;3540853
Pracinha;2014;249;115;134;3540853
Pracinha;2015;254;122;132;3540853
Pracinha;2016;262;120;142;3540853
Pracinha;2017;279;132;147;3540853
Pradópolis;2013;7142;5774;1368;3540903
Pradópolis;2014;7397;5914;1483;3540903
Pradópolis;2015;7307;5847;1460;3540903
Pradópolis;2016;7045;5597;1448;3540903
Pradópolis;2017;7047;5541;1506;3540903
Praia Grande;2013;43934;22726;21208;3541000
Praia Grande;2014;45992;23861;22131;3541000
Praia Grande;2015;46656;24534;22122;3541000
Praia Grande;2016;47609;24640;22969;3541000
Praia Grande;2017;47600;24747;22853;3541000
Pratânia;2013;1120;719;401;3541059
Pratânia;2014;1280;857;423;3541059
Pratânia;2015;1053;676;377;3541059
Pratânia;2016;1225;850;375;3541059
Pratânia;2017;1159;791;368;3541059
Presidente Alves;2013;712;395;317;3541109
Presidente Alves;2014;668;345;323;3541109
Presidente Alves;2015;695;374;321;3541109
Presidente Alves;2016;648;363;285;3541109
Presidente Alves;2017;605;327;278;3541109
Presidente Bernardes;2013;2066;1159;907;3541208
Presidente Bernardes;2014;2015;1110;905;3541208
Presidente Bernardes;2015;2049;1186;863;3541208
Presidente Bernardes;2016;2120;1228;892;3541208
Presidente Bernardes;2017;2046;1201;845;3541208
Presidente Epitácio;2013;7078;4080;2998;3541307
Presidente Epitácio;2014;7077;3920;3157;3541307
Presidente Epitácio;2015;6792;3757;3035;3541307
Presidente Epitácio;2016;5851;3103;2748;3541307
Presidente Epitácio;2017;5405;2894;2511;3541307
Presidente Prudente;2013;67790;38138;29652;3541406
Presidente Prudente;2014;69069;38693;30376;3541406
Presidente Prudente;2015;68538;38249;30289;3541406
Presidente Prudente;2016;67562;37508;30054;3541406
Presidente Prudente;2017;66293;36533;29760;3541406
Presidente Venceslau;2013;6398;3376;3022;3541505
Presidente Venceslau;2014;6348;3254;3094;3541505
Presidente Venceslau;2015;6592;3535;3057;3541505
Presidente Venceslau;2016;6351;3305;3046;3541505
Presidente Venceslau;2017;5942;2938;3004;3541505
Promissão;2013;12141;8223;3918;3541604
Promissão;2014;9203;5274;3929;3541604
Promissão;2015;10170;6549;3621;3541604
Promissão;2016;9671;6248;3423;3541604
Promissão;2017;9121;5641;3480;3541604
Quadra;2013;494;299;195;3541653
Quadra;2014;521;301;220;3541653
Quadra;2015;580;317;263;3541653
Quadra;2016;528;308;220;3541653
Quadra;2017;573;326;247;3541653
Quatá;2013;4260;3225;1035;3541703
Quatá;2014;4193;3074;1119;3541703
Quatá;2015;4274;3065;1209;3541703
Quatá;2016;3880;2691;1189;3541703
Quatá;2017;3946;2828;1118;3541703
Queiroz;2013;780;485;295;3541802
Queiroz;2014;854;518;336;3541802
Queiroz;2015;847;535;312;3541802
Queiroz;2016;930;590;340;3541802
Queiroz;2017;942;601;341;3541802
Queluz;2013;1719;980;739;3541901
Queluz;2014;1750;956;794;3541901
Queluz;2015;1940;1034;906;3541901
Queluz;2016;1794;991;803;3541901
Queluz;2017;1669;950;719;3541901
Quintana;2013;1314;841;473;3542008
Quintana;2014;1196;744;452;3542008
Quintana;2015;1130;683;447;3542008
Quintana;2016;1203;745;458;3542008
Quintana;2017;1264;769;495;3542008
Rafard;2013;3418;2476;942;3542107
Rafard;2014;3188;2300;888;3542107
Rafard;2015;2943;2094;849;3542107
Rafard;2016;2801;1985;816;3542107
Rafard;2017;2776;1835;941;3542107
Rancharia;2013;7608;4615;2993;3542206
Rancharia;2014;7424;4433;2991;3542206
Rancharia;2015;7511;4471;3040;3542206
Rancharia;2016;7218;4356;2862;3542206
Rancharia;2017;7161;4332;2829;3542206
Redenção da Serra;2013;537;351;186;3542305
Redenção da Serra;2014;586;401;185;3542305
Redenção da Serra;2015;592;406;186;3542305
Redenção da Serra;2016;579;366;213;3542305
Redenção da Serra;2017;585;397;188;3542305
Regente Feijó;2013;6772;5105;1667;3542404
Regente Feijó;2014;4899;3145;1754;3542404
Regente Feijó;2015;4368;2689;1679;3542404
Regente Feijó;2016;4476;2756;1720;3542404
Regente Feijó;2017;4449;2801;1648;3542404
Reginópolis;2013;881;544;337;3542503
Reginópolis;2014;908;531;377;3542503
Reginópolis;2015;911;521;390;3542503
Reginópolis;2016;891;501;390;3542503
Reginópolis;2017;1007;605;402;3542503
Registro;2013;13495;7730;5767;3542602
Registro;2014;14036;8045;5991;3542602
Registro;2015;13361;7648;5713;3542602
Registro;2016;13154;7373;5781;3542602
Registro;2017;13411;7638;5773;3542602
Restinga;2013;1582;1172;410;3542701
Restinga;2014;1532;1119;413;3542701
Restinga;2015;1746;1343;403;3542701
Restinga;2016;1330;1108;222;3542701
Restinga;2017;1615;1217;398;3542701
Ribeira;2013;421;287;134;3542800
Ribeira;2014;473;309;164;3542800
Ribeira;2015;439;306;133;3542800
Ribeira;2016;461;328;133;3542800
Ribeira;2017;525;375;150;3542800
Ribeirão Bonito;2013;2275;1391;884;3542909
Ribeirão Bonito;2014;2407;1538;869;3542909
Ribeirão Bonito;2015;1983;1184;799;3542909
Ribeirão Bonito;2016;1812;1016;796;3542909
Ribeirão Bonito;2017;1806;1024;782;3542909
Ribeirão Branco;2013;3409;2302;1107;3543006
Ribeirão Branco;2014;3682;2479;1203;3543006
Ribeirão Branco;2015;3718;2503;1215;3543006
Ribeirão Branco;2016;3514;2427;1087;3543006
Ribeirão Branco;2017;3214;2230;984;3543006
Ribeirão Corrente;2013;648;411;237;3543105
Ribeirão Corrente;2014;695;446;249;3543105
Ribeirão Corrente;2015;713;451;262;3543105
Ribeirão Corrente;2016;680;456;224;3543105
Ribeirão Corrente;2017;689;446;243;3543105
Ribeirão do Sul;2013;699;425;274;3543204
Ribeirão do Sul;2014;697;395;302;3543204
Ribeirão do Sul;2015;640;378;262;3543204
Ribeirão do Sul;2016;613;365;248;3543204
Ribeirão do Sul;2017;617;381;236;3543204
Ribeirão dos Índios;2013;275;133;142;3543238
Ribeirão dos Índios;2014;303;142;161;3543238
Ribeirão dos Índios;2015;321;149;172;3543238
Ribeirão dos Índios;2016;289;128;161;3543238
Ribeirão dos Índios;2017;322;153;169;3543238
Ribeirão Grande;2013;1020;653;367;3543253
Ribeirão Grande;2014;1284;892;392;3543253
Ribeirão Grande;2015;1029;667;362;3543253
Ribeirão Grande;2016;828;474;354;3543253
Ribeirão Grande;2017;696;401;295;3543253
Ribeirão Pires;2013;24288;14109;10179;3543303
Ribeirão Pires;2014;24779;13958;10821;3543303
Ribeirão Pires;2015;23544;13193;10351;3543303
Ribeirão Pires;2016;21890;12439;9451;3543303
Ribeirão Pires;2017;21515;12495;9020;3543303
Ribeirão Preto;2013;230619;126312;104307;3543402
Ribeirão Preto;2014;233129;125572;107557;3543402
Ribeirão Preto;2015;226584;121165;105419;3543402
Ribeirão Preto;2016;222821;118881;103940;3543402
Ribeirão Preto;2017;222877;118319;104558;3543402
Rifaina;2013;523;323;200;3543600
Rifaina;2014;615;383;232;3543600
Rifaina;2015;728;396;332;3543600
Rifaina;2016;743;422;321;3543600
Rifaina;2017;705;418;287;3543600
Rincão;2013;1594;930;664;3543709
Rincão;2014;1570;888;682;3543709
Rincão;2015;1615;929;686;3543709
Rincão;2016;1522;898;624;3543709
Rincão;2017;1470;871;599;3543709
Rinópolis;2013;2036;1157;879;3543808
Rinópolis;2014;2301;1261;1040;3543808
Rinópolis;2015;1852;1182;670;3543808
Rinópolis;2016;1672;1022;650;3543808
Rinópolis;2017;1771;1142;629;3543808
Rio Claro;2013;67009;36442;30567;3543907
Rio Claro;2014;66811;36613;30198;3543907
Rio Claro;2015;65112;35959;29153;3543907
Rio Claro;2016;61302;32851;28451;3543907
Rio Claro;2017;62683;35880;26803;3543907
Rio das Pedras;2013;9436;6652;2784;3544004
Rio das Pedras;2014;8694;6069;2625;3544004
Rio das Pedras;2015;8103;5517;2586;3544004
Rio das Pedras;2016;7930;5331;2599;3544004
Rio das Pedras;2017;8541;5928;2613;3544004
Rio Grande da Serra;2013;4204;2522;1682;3544103
Rio Grande da Serra;2014;3857;2287;1570;3544103
Rio Grande da Serra;2015;4044;2439;1605;3544103
Rio Grande da Serra;2016;3985;2306;1679;3544103
Rio Grande da Serra;2017;3582;2031;1551;3544103
Riolândia;2013;922;495;427;3544202
Riolândia;2014;962;517;445;3544202
Riolândia;2015;1003;507;496;3544202
Riolândia;2016;1010;504;506;3544202
Riolândia;2017;1012;495;517;3544202
Riversul;2013;533;284;249;3543501
Riversul;2014;538;296;242;3543501
Riversul;2015;581;321;260;3543501
Riversul;2016;534;301;233;3543501
Riversul;2017;535;291;244;3543501
Rosana;2013;2579;1227;1352;3544251
Rosana;2014;2686;1284;1402;3544251
Rosana;2015;2682;1304;1378;3544251
Rosana;2016;2524;1224;1300;3544251
Rosana;2017;2472;1168;1304;3544251
Roseira;2013;2367;1485;882;3544301
Roseira;2014;1981;1197;784;3544301
Roseira;2015;2106;1268;838;3544301
Roseira;2016;2085;1261;824;3544301
Roseira;2017;2329;1434;895;3544301
Rubiácea;2013;389;240;149;3544400
Rubiácea;2014;382;233;149;3544400
Rubiácea;2015;319;176;143;3544400
Rubiácea;2016;374;217;157;3544400
Rubiácea;2017;359;204;155;3544400
Rubinéia;2013;497;259;238;3544509
Rubinéia;2014;514;278;236;3544509
Rubinéia;2015;596;328;268;3544509
Rubinéia;2016;611;341;270;3544509
Rubinéia;2017;634;361;273;3544509
Sabino;2013;634;322;312;3544608
Sabino;2014;651;334;317;3544608
Sabino;2015;649;336;313;3544608
Sabino;2016;603;309;294;3544608
Sabino;2017;582;307;275;3544608
Sagres;2013;375;152;223;3544707
Sagres;2014;482;229;253;3544707
Sagres;2015;414;176;238;3544707
Sagres;2016;394;164;230;3544707
Sagres;2017;404;175;229;3544707
Sales;2013;744;410;334;3544806
Sales;2014;779;421;358;3544806
Sales;2015;765;415;350;3544806
Sales;2016;797;432;365;3544806
Sales;2017;812;436;376;3544806
Sales Oliveira;2013;2478;1594;884;3544905
Sales Oliveira;2014;2524;1606;918;3544905
Sales Oliveira;2015;2490;1553;937;3544905
Sales Oliveira;2016;2488;1526;962;3544905
Sales Oliveira;2017;2183;1209;974;3544905
Salesópolis;2013;2144;1290;854;3545001
Salesópolis;2014;2174;1238;936;3545001
Salesópolis;2015;2123;1198;925;3545001
Salesópolis;2016;2131;1223;908;3545001
Salesópolis;2017;2295;1287;1008;3545001
Salmourão;2013;506;228;278;3545100
Salmourão;2014;518;235;283;3545100
Salmourão;2015;535;262;273;3545100
Salmourão;2016;520;255;265;3545100
Salmourão;2017;509;270;239;3545100
Saltinho;2013;1718;1100;618;3545159
Saltinho;2014;1596;990;606;3545159
Saltinho;2015;1598;977;621;3545159
Saltinho;2016;1548;965;583;3545159
Saltinho;2017;1431;867;564;3545159
Salto;2013;30224;16119;14105;3545209
Salto;2014;30475;16093;14382;3545209
Salto;2015;30126;16013;14113;3545209
Salto;2016;28699;15271;13428;3545209
Salto;2017;28627;15972;12655;3545209
Salto de Pirapora;2013;5929;3600;2329;3545308
Salto de Pirapora;2014;6399;3939;2460;3545308
Salto de Pirapora;2015;6514;3983;2531;3545308
Salto de Pirapora;2016;6594;4162;2432;3545308
Salto de Pirapora;2017;6350;4008;2342;3545308
Salto Grande;2013;1378;865;513;3545407
Salto Grande;2014;1364;863;501;3545407
Salto Grande;2015;1399;860;539;3545407
Salto Grande;2016;1343;832;511;3545407
Salto Grande;2017;1386;856;530;3545407
Sandovalina;2013;2002;1581;421;3545506
Sandovalina;2014;2338;1858;480;3545506
Sandovalina;2015;2164;1730;434;3545506
Sandovalina;2016;2090;1682;408;3545506
Sandovalina;2017;2184;1774;410;3545506
Santa Adélia;2013;4634;3240;1394;3545605
Santa Adélia;2014;4557;3138;1419;3545605
Santa Adélia;2015;4572;3154;1418;3545605
Santa Adélia;2016;4431;3023;1408;3545605
Santa Adélia;2017;4314;2933;1381;3545605
Santa Albertina;2013;1930;1546;384;3545704
Santa Albertina;2014;1979;1556;423;3545704
Santa Albertina;2015;2175;1723;452;3545704
Santa Albertina;2016;2034;1615;419;3545704
Santa Albertina;2017;1963;1547;416;3545704
Santa Bárbara d'Oeste;2013;47595;26495;21100;3545803
Santa Bárbara d'Oeste;2014;48333;26763;21570;3545803
Santa Bárbara d'Oeste;2015;45816;24915;20901;3545803
Santa Bárbara d'Oeste;2016;47015;25412;21603;3545803
Santa Bárbara d'Oeste;2017;44399;24237;20162;3545803
Santa Branca;2013;3004;2043;961;3546009
Santa Branca;2014;2350;1479;871;3546009
Santa Branca;2015;2528;1479;1049;3546009
Santa Branca;2016;2147;1172;975;3546009
Santa Branca;2017;4133;2902;1231;3546009
Santa Clara d'Oeste;2013;731;404;327;3546108
Santa Clara d'Oeste;2014;750;409;341;3546108
Santa Clara d'Oeste;2015;494;306;188;3546108
Santa Clara d'Oeste;2016;505;306;199;3546108
Santa Clara d'Oeste;2017;575;357;218;3546108
Santa Cruz da Conceição;2013;1435;1015;420;3546207
Santa Cruz da Conceição;2014;1425;995;430;3546207
Santa Cruz da Conceição;2015;1332;917;415;3546207
Santa Cruz da Conceição;2016;1175;820;355;3546207
Santa Cruz da Conceição;2017;1215;836;379;3546207
Santa Cruz da Esperança;2013;318;178;140;3546256
Santa Cruz da Esperança;2014;350;180;170;3546256
Santa Cruz da Esperança;2015;368;194;174;3546256
Santa Cruz da Esperança;2016;377;192;185;3546256
Santa Cruz da Esperança;2017;395;198;197;3546256
Santa Cruz das Palmeiras;2013;6437;4237;2200;3546306
Santa Cruz das Palmeiras;2014;6131;3925;2206;3546306
Santa Cruz das Palmeiras;2015;6147;4011;2136;3546306
Santa Cruz das Palmeiras;2016;5955;3853;2102;3546306
Santa Cruz das Palmeiras;2017;5408;3257;2151;3546306
Santa Cruz do Rio Pardo;2013;13476;8177;5299;3546405
Santa Cruz do Rio Pardo;2014;13622;8285;5337;3546405
Santa Cruz do Rio Pardo;2015;14319;8750;5569;3546405
Santa Cruz do Rio Pardo;2016;13776;8424;5352;3546405
Santa Cruz do Rio Pardo;2017;14700;9344;5356;3546405
Santa Ernestina;2013;494;272;222;3546504
Santa Ernestina;2014;517;295;222;3546504
Santa Ernestina;2015;511;290;221;3546504
Santa Ernestina;2016;518;274;244;3546504
Santa Ernestina;2017;496;249;247;3546504
Santa Fé do Sul;2013;8227;4501;3726;3546603
Santa Fé do Sul;2014;8536;4528;4008;3546603
Santa Fé do Sul;2015;8396;4474;3922;3546603
Santa Fé do Sul;2016;8503;4439;4064;3546603
Santa Fé do Sul;2017;7772;4023;3749;3546603
Santa Gertrudes;2013;7358;5257;2101;3546702
Santa Gertrudes;2014;7686;5554;2132;3546702
Santa Gertrudes;2015;7821;5626;2195;3546702
Santa Gertrudes;2016;7315;5233;2082;3546702
Santa Gertrudes;2017;7246;5158;2088;3546702
Santa Isabel;2013;11077;6537;4540;3546801
Santa Isabel;2014;11312;6508;4804;3546801
Santa Isabel;2015;10747;5992;4755;3546801
Santa Isabel;2016;10635;5984;4651;3546801
Santa Isabel;2017;11087;6292;4795;3546801
Santa Lúcia;2013;855;559;296;3546900
Santa Lúcia;2014;650;358;292;3546900
Santa Lúcia;2015;626;334;292;3546900
Santa Lúcia;2016;639;336;303;3546900
Santa Lúcia;2017;652;347;305;3546900
Santa Maria da Serra;2013;1245;684;561;3547007
Santa Maria da Serra;2014;1162;661;501;3547007
Santa Maria da Serra;2015;1070;635;435;3547007
Santa Maria da Serra;2016;981;583;398;3547007
Santa Maria da Serra;2017;1000;622;378;3547007
Santa Mercedes;2013;524;307;217;3547106
Santa Mercedes;2014;484;279;205;3547106
Santa Mercedes;2015;440;247;193;3547106
Santa Mercedes;2016;393;218;175;3547106
Santa Mercedes;2017;402;219;183;3547106
Santa Rita d'Oeste;2013;349;176;173;3547403
Santa Rita d'Oeste;2014;382;204;178;3547403
Santa Rita d'Oeste;2015;463;262;201;3547403
Santa Rita d'Oeste;2016;374;200;174;3547403
Santa Rita d'Oeste;2017;394;209;185;3547403
Santa Rita do Passa Quatro;2013;6003;3649;2354;3547502
Santa Rita do Passa Quatro;2014;5345;3025;2320;3547502
Santa Rita do Passa Quatro;2015;5186;2976;2210;3547502
Santa Rita do Passa Quatro;2016;5345;3104;2241;3547502
Santa Rita do Passa Quatro;2017;5387;3182;2205;3547502
Santa Rosa de Viterbo;2013;5172;3335;1837;3547601
Santa Rosa de Viterbo;2014;4841;3023;1818;3547601
Santa Rosa de Viterbo;2015;4468;2668;1800;3547601
Santa Rosa de Viterbo;2016;4164;2453;1711;3547601
Santa Rosa de Viterbo;2017;4364;2514;1850;3547601
Santa Salete;2013;229;122;107;3547650
Santa Salete;2014;227;119;108;3547650
Santa Salete;2015;224;117;107;3547650
Santa Salete;2016;222;126;96;3547650
Santa Salete;2017;247;144;103;3547650
Santana da Ponte Pensa;2013;277;168;109;3547205
Santana da Ponte Pensa;2014;247;152;95;3547205
Santana da Ponte Pensa;2015;229;142;87;3547205
Santana da Ponte Pensa;2016;254;157;97;3547205
Santana da Ponte Pensa;2017;237;137;100;3547205
Santana de Parnaíba;2013;63476;37973;25503;3547304
Santana de Parnaíba;2014;66771;39264;27507;3547304
Santana de Parnaíba;2015;61307;35531;25776;3547304
Santana de Parnaíba;2016;59061;35195;23866;3547304
Santana de Parnaíba;2017;56733;33730;23003;3547304
Santo Anastácio;2013;3149;1831;1318;3547700
Santo Anastácio;2014;3229;1875;1354;3547700
Santo Anastácio;2015;3407;1981;1426;3547700
Santo Anastácio;2016;3257;1896;1361;3547700
Santo Anastácio;2017;3206;1897;1309;3547700
Santo André;2013;215122;116572;98550;3547809
Santo André;2014;215750;115557;100193;3547809
Santo André;2015;207327;108629;98698;3547809
Santo André;2016;195125;101367;93758;3547809
Santo André;2017;198298;102967;95331;3547809
Santo Antônio da Alegria;2013;1042;595;447;3547908
Santo Antônio da Alegria;2014;1079;618;461;3547908
Santo Antônio da Alegria;2015;1036;618;418;3547908
Santo Antônio da Alegria;2016;1075;629;446;3547908
Santo Antônio da Alegria;2017;1105;614;491;3547908
Santo Antônio de Posse;2013;7857;4977;2880;3548005
Santo Antônio de Posse;2014;7921;5029;2892;3548005
Santo Antônio de Posse;2015;7874;4630;3244;3548005
Santo Antônio de Posse;2016;7705;4366;3339;3548005
Santo Antônio de Posse;2017;8230;4653;3577;3548005
Santo Antônio do Aracanguá;2013;3280;2235;1045;3548054
Santo Antônio do Aracanguá;2014;2159;1262;897;3548054
Santo Antônio do Aracanguá;2015;1834;1034;800;3548054
Santo Antônio do Aracanguá;2016;1766;1025;741;3548054
Santo Antônio do Aracanguá;2017;1759;1002;757;3548054
Santo Antônio do Jardim;2013;1343;818;525;3548104
Santo Antônio do Jardim;2014;1379;869;510;3548104
Santo Antônio do Jardim;2015;1330;804;526;3548104
Santo Antônio do Jardim;2016;1266;799;467;3548104
Santo Antônio do Jardim;2017;1276;791;485;3548104
Santo Antônio do Pinhal;2013;1067;526;541;3548203
Santo Antônio do Pinhal;2014;1134;566;568;3548203
Santo Antônio do Pinhal;2015;1086;537;549;3548203
Santo Antônio do Pinhal;2016;1161;581;580;3548203
Santo Antônio do Pinhal;2017;1194;604;590;3548203
Santo Expedito;2013;324;163;161;3548302
Santo Expedito;2014;348;175;173;3548302
Santo Expedito;2015;382;175;207;3548302
Santo Expedito;2016;336;162;174;3548302
Santo Expedito;2017;343;162;181;3548302
Santópolis do Aguapeí;2013;564;322;242;3548401
Santópolis do Aguapeí;2014;554;304;250;3548401
Santópolis do Aguapeí;2015;590;280;310;3548401
Santópolis do Aguapeí;2016;492;275;217;3548401
Santópolis do Aguapeí;2017;474;268;206;3548401
Santos;2013;189731;105205;84526;3548500
Santos;2014;192494;106536;85958;3548500
Santos;2015;181262;100473;80789;3548500
Santos;2016;174988;96802;78186;3548500
Santos;2017;173018;95612;77406;3548500
São Bento do Sapucaí;2013;1323;704;619;3548609
São Bento do Sapucaí;2014;1356;749;607;3548609
São Bento do Sapucaí;2015;1592;863;729;3548609
São Bento do Sapucaí;2016;1532;836;696;3548609
São Bento do Sapucaí;2017;1534;842;692;3548609
São Bernardo do Campo;2013;292028;184088;107940;3548708
São Bernardo do Campo;2014;287065;178027;109038;3548708
São Bernardo do Campo;2015;273721;164701;109020;3548708
São Bernardo do Campo;2016;252289;150966;101323;3548708
São Bernardo do Campo;2017;249142;147711;101431;3548708
São Caetano do Sul;2013;113079;64806;48273;3548807
São Caetano do Sul;2014;112826;61916;50910;3548807
São Caetano do Sul;2015;109409;59353;50056;3548807
São Caetano do Sul;2016;101509;56191;45318;3548807
São Caetano do Sul;2017;103620;55001;48619;3548807
São Carlos;2013;76892;44940;31952;3548906
São Carlos;2014;77643;45042;32601;3548906
São Carlos;2015;74746;43519;31227;3548906
São Carlos;2016;73841;42497;31344;3548906
São Carlos;2017;74097;42822;31275;3548906
São Francisco;2013;237;134;103;3549003
São Francisco;2014;228;129;99;3549003
São Francisco;2015;245;126;119;3549003
São Francisco;2016;242;114;128;3549003
São Francisco;2017;227;106;121;3549003
São João da Boa Vista;2013;25138;14697;10441;3549102
São João da Boa Vista;2014;24876;14481;10395;3549102
São João da Boa Vista;2015;24235;13827;10408;3549102
São João da Boa Vista;2016;23904;13553;10351;3549102
São João da Boa Vista;2017;24063;13670;10393;3549102
São João das Duas Pontes;2013;240;146;94;3549201
São João das Duas Pontes;2014;244;149;95;3549201
São João das Duas Pontes;2015;269;152;117;3549201
São João das Duas Pontes;2016;274;156;118;3549201
São João das Duas Pontes;2017;271;150;121;3549201
São João de Iracema;2013;286;157;129;3549250
São João de Iracema;2014;271;144;127;3549250
São João de Iracema;2015;296;151;145;3549250
São João de Iracema;2016;282;145;137;3549250
São João de Iracema;2017;91;59;32;3549250
São João do Pau d'Alho;2013;226;120;106;3549300
São João do Pau d'Alho;2014;227;121;106;3549300
São João do Pau d'Alho;2015;233;127;106;3549300
São João do Pau d'Alho;2016;229;120;109;3549300
São João do Pau d'Alho;2017;228;119;109;3549300
São Joaquim da Barra;2013;12566;8216;4350;3549409
São Joaquim da Barra;2014;12528;8205;4323;3549409
São Joaquim da Barra;2015;12165;7895;4270;3549409
São Joaquim da Barra;2016;11457;7387;4070;3549409
São Joaquim da Barra;2017;11713;7664;4049;3549409
São José da Bela Vista;2013;792;397;395;3549508
São José da Bela Vista;2014;865;429;436;3549508
São José da Bela Vista;2015;939;454;485;3549508
São José da Bela Vista;2016;844;390;454;3549508
São José da Bela Vista;2017;827;411;416;3549508
São José do Barreiro;2013;505;304;201;3549607
São José do Barreiro;2014;512;298;214;3549607
São José do Barreiro;2015;517;305;212;3549607
São José do Barreiro;2016;502;295;207;3549607
São José do Barreiro;2017;476;275;201;3549607
São José do Rio Pardo;2013;15204;9233;5971;3549706
São José do Rio Pardo;2014;15638;9492;6146;3549706
São José do Rio Pardo;2015;15571;9484;6087;3549706
São José do Rio Pardo;2016;15112;9118;5994;3549706
São José do Rio Pardo;2017;14896;8979;5917;3549706
São José do Rio Preto;2013;140718;78207;62511;3549805
São José do Rio Preto;2014;143969;78963;65006;3549805
São José do Rio Preto;2015;138789;74690;64099;3549805
São José do Rio Preto;2016;132787;71298;61489;3549805
São José do Rio Preto;2017;136102;72881;63221;3549805
São José dos Campos;2013;211462;126880;84582;3549904
São José dos Campos;2014;209777;123653;86124;3549904
São José dos Campos;2015;201142;118770;82372;3549904
São José dos Campos;2016;192181;112939;79242;3549904
São José dos Campos;2017;187441;109639;77802;3549904
São Lourenço da Serra;2013;6726;2616;4110;3549953
São Lourenço da Serra;2014;5182;2140;3042;3549953
São Lourenço da Serra;2015;7022;2425;4597;3549953
São Lourenço da Serra;2016;8123;2473;5650;3549953
São Lourenço da Serra;2017;8304;2608;5696;3549953
São Luís do Paraitinga;2013;1606;964;642;3550001
São Luís do Paraitinga;2014;1696;1037;659;3550001
São Luís do Paraitinga;2015;1741;1071;670;3550001
São Luís do Paraitinga;2016;1727;1056;671;3550001
São Luís do Paraitinga;2017;1913;1189;724;3550001
São Manuel;2013;9239;5825;3414;3550100
São Manuel;2014;8775;5495;3280;3550100
São Manuel;2015;8551;5362;3189;3550100
São Manuel;2016;8499;5379;3120;3550100
São Manuel;2017;8526;5369;3157;3550100
São Miguel Arcanjo;2013;4600;2830;1770;3550209
São Miguel Arcanjo;2014;4492;2635;1857;3550209
São Miguel Arcanjo;2015;4424;2589;1835;3550209
São Miguel Arcanjo;2016;4393;2575;1818;3550209
São Miguel Arcanjo;2017;4316;2550;1766;3550209
São Paulo;2013;5247898;2824442;2423462;3550308
São Paulo;2014;5308401;2836022;2472379;3550308
São Paulo;2015;5126131;2717025;2409106;3550308
São Paulo;2016;4952351;2612922;2339429;3550308
São Paulo;2017;4867306;2569811;2297495;3550308
São Pedro;2013;5943;3175;2768;3550407
São Pedro;2014;6151;3206;2945;3550407
São Pedro;2015;6108;3177;2931;3550407
São Pedro;2016;6029;3111;2918;3550407
São Pedro;2017;6146;3214;2932;3550407
São Pedro do Turvo;2013;1255;809;446;3550506
São Pedro do Turvo;2014;1314;838;476;3550506
São Pedro do Turvo;2015;1344;883;461;3550506
São Pedro do Turvo;2016;1275;840;435;3550506
São Pedro do Turvo;2017;1480;1015;465;3550506
São Roque;2013;20085;9974;10111;3550605
São Roque;2014;21455;10238;11217;3550605
São Roque;2015;21622;10426;11196;3550605
São Roque;2016;20716;9870;10846;3550605
São Roque;2017;20702;9877;10825;3550605
São Sebastião;2013;19486;11881;7605;3550704
São Sebastião;2014;19873;12333;7540;3550704
São Sebastião;2015;20523;12571;7952;3550704
São Sebastião;2016;20365;12577;7788;3550704
São Sebastião;2017;20815;13064;7751;3550704
São Sebastião da Grama;2013;3127;1897;1230;3550803
São Sebastião da Grama;2014;3239;1981;1258;3550803
São Sebastião da Grama;2015;2873;1786;1087;3550803
São Sebastião da Grama;2016;3236;1947;1289;3550803
São Sebastião da Grama;2017;2872;1645;1227;3550803
São Simão;2013;3392;2121;1271;3550902
São Simão;2014;3606;2178;1428;3550902
São Simão;2015;3508;2114;1394;3550902
São Simão;2016;3338;2052;1286;3550902
São Simão;2017;3526;2201;1325;3550902
São Vicente;2013;41321;20457;20864;3551009
São Vicente;2014;41183;19799;21384;3551009
São Vicente;2015;41194;19829;21365;3551009
São Vicente;2016;36967;17941;19026;3551009
São Vicente;2017;35384;17051;18333;3551009
Sarapuí;2013;2003;1177;826;3551108
Sarapuí;2014;1931;1136;795;3551108
Sarapuí;2015;1800;1085;715;3551108
Sarapuí;2016;1792;1091;701;3551108
Sarapuí;2017;1669;990;679;3551108
Sarutaiá;2013;475;243;232;3551207
Sarutaiá;2014;453;226;227;3551207
Sarutaiá;2015;500;258;242;3551207
Sarutaiá;2016;457;228;229;3551207
Sarutaiá;2017;543;271;272;3551207
Sebastianópolis do Sul;2013;2977;2418;559;3551306
Sebastianópolis do Sul;2014;2964;2422;542;3551306
Sebastianópolis do Sul;2015;2672;2137;535;3551306
Sebastianópolis do Sul;2016;2352;1880;472;3551306
Sebastianópolis do Sul;2017;2349;1909;440;3551306
Serra Azul;2013;825;460;365;3551405
Serra Azul;2014;944;580;364;3551405
Serra Azul;2015;854;464;390;3551405
Serra Azul;2016;774;430;344;3551405
Serra Azul;2017;772;414;358;3551405
Serra Negra;2013;6497;3325;3172;3551603
Serra Negra;2014;6976;3634;3342;3551603
Serra Negra;2015;6870;3552;3318;3551603
Serra Negra;2016;6734;3475;3259;3551603
Serra Negra;2017;6675;3459;3216;3551603
Serrana;2013;7453;4904;2549;3551504
Serrana;2014;6833;4342;2491;3551504
Serrana;2015;6694;4299;2395;3551504
Serrana;2016;6817;4505;2312;3551504
Serrana;2017;7064;4631;2433;3551504
Sertãozinho;2013;47390;33342;14048;3551702
Sertãozinho;2014;45777;32035;13742;3551702
Sertãozinho;2015;42589;29103;13486;3551702
Sertãozinho;2016;40912;27931;12981;3551702
Sertãozinho;2017;39879;27157;12722;3551702
Sete Barras;2013;1717;1195;522;3551801
Sete Barras;2014;1775;1204;571;3551801
Sete Barras;2015;1780;1206;574;3551801
Sete Barras;2016;1830;1235;595;3551801
Sete Barras;2017;1780;1244;536;3551801
Severínia;2013;2378;1435;943;3551900
Severínia;2014;2291;1356;935;3551900
Severínia;2015;2028;1182;846;3551900
Severínia;2016;2222;1291;931;3551900
Severínia;2017;2204;1291;913;3551900
Silveiras;2013;709;416;293;3552007
Silveiras;2014;747;422;325;3552007
Silveiras;2015;754;431;323;3552007
Silveiras;2016;739;418;321;3552007
Silveiras;2017;819;449;370;3552007
Socorro;2013;7111;3603;3508;3552106
Socorro;2014;7439;3743;3696;3552106
Socorro;2015;7324;3685;3639;3552106
Socorro;2016;7678;3934;3744;3552106
Socorro;2017;7754;3941;3813;3552106
Sorocaba;2013;206073;121378;84695;3552205
Sorocaba;2014;211073;122122;88951;3552205
Sorocaba;2015;199745;114150;85595;3552205
Sorocaba;2016;191446;109043;82403;3552205
Sorocaba;2017;191120;107841;83279;3552205
Sud Mennucci;2013;1384;751;633;3552304
Sud Mennucci;2014;1235;684;551;3552304
Sud Mennucci;2015;1277;724;553;3552304
Sud Mennucci;2016;1261;741;520;3552304
Sud Mennucci;2017;1344;796;548;3552304
Sumaré;2013;52998;34695;18303;3552403
Sumaré;2014;54770;35707;19063;3552403
Sumaré;2015;55637;36405;19232;3552403
Sumaré;2016;54331;35599;18732;3552403
Sumaré;2017;57067;37078;19989;3552403
Suzanápolis;2013;1326;1006;320;3552551
Suzanápolis;2014;1438;1117;321;3552551
Suzanápolis;2015;1492;1168;324;3552551
Suzanápolis;2016;1503;1149;354;3552551
Suzanápolis;2017;1634;1260;374;3552551
Suzano;2013;53573;32644;20929;3552502
Suzano;2014;54368;33091;21277;3552502
Suzano;2015;54701;32463;22238;3552502
Suzano;2016;53706;31596;22110;3552502
Suzano;2017;56357;33041;23316;3552502
Tabapuã;2013;2332;1350;982;3552601
Tabapuã;2014;2376;1405;971;3552601
Tabapuã;2015;2248;1344;904;3552601
Tabapuã;2016;1908;1106;802;3552601
Tabapuã;2017;1960;1121;839;3552601
Tabatinga;2013;3800;1998;1802;3552700
Tabatinga;2014;3550;1757;1793;3552700
Tabatinga;2015;3164;1587;1577;3552700
Tabatinga;2016;2883;1354;1529;3552700
Tabatinga;2017;3703;2015;1688;3552700
Taboão da Serra;2013;62184;35742;26442;3552809
Taboão da Serra;2014;61780;34623;27157;3552809
Taboão da Serra;2015;62382;34271;28111;3552809
Taboão da Serra;2016;60655;32588;28067;3552809
Taboão da Serra;2017;59267;31377;27890;3552809
Taciba;2013;847;437;410;3552908
Taciba;2014;839;458;381;3552908
Taciba;2015;815;445;370;3552908
Taciba;2016;754;394;360;3552908
Taciba;2017;828;442;386;3552908
Taguaí;2013;4401;2005;2396;3553005
Taguaí;2014;4640;2133;2507;3553005
Taguaí;2015;4242;1992;2250;3553005
Taguaí;2016;4584;2130;2454;3553005
Taguaí;2017;4554;2168;2386;3553005
Taiaçu;2013;630;367;263;3553104
Taiaçu;2014;628;361;267;3553104
Taiaçu;2015;600;347;253;3553104
Taiaçu;2016;580;322;258;3553104
Taiaçu;2017;637;366;271;3553104
Taiúva;2013;789;472;317;3553203
Taiúva;2014;748;439;309;3553203
Taiúva;2015;743;416;327;3553203
Taiúva;2016;768;435;333;3553203
Taiúva;2017;749;422;327;3553203
Tambaú;2013;6317;4046;2271;3553302
Tambaú;2014;6747;4234;2513;3553302
Tambaú;2015;6736;4278;2458;3553302
Tambaú;2016;5995;3803;2192;3553302
Tambaú;2017;5566;3532;2034;3553302
Tanabi;2013;5141;3291;1850;3553401
Tanabi;2014;5325;3279;2046;3553401
Tanabi;2015;5463;3523;1940;3553401
Tanabi;2016;5149;3194;1955;3553401
Tanabi;2017;5248;3291;1957;3553401
Tapiraí;2013;1154;686;468;3553500
Tapiraí;2014;1194;708;486;3553500
Tapiraí;2015;1184;689;495;3553500
Tapiraí;2016;1167;668;499;3553500
Tapiraí;2017;1165;694;471;3553500
Tapiratiba;2013;2811;1949;862;3553609
Tapiratiba;2014;2929;2022;907;3553609
Tapiratiba;2015;3135;2201;934;3553609
Tapiratiba;2016;3214;2210;1004;3553609
Tapiratiba;2017;3214;2191;1023;3553609
Taquaral;2013;500;292;208;3553658
Taquaral;2014;556;323;233;3553658
Taquaral;2015;563;331;232;3553658
Taquaral;2016;534;302;232;3553658
Taquaral;2017;520;295;225;3553658
Taquaritinga;2013;10851;6026;4825;3553708
Taquaritinga;2014;11095;6242;4853;3553708
Taquaritinga;2015;10759;5905;4854;3553708
Taquaritinga;2016;10732;5964;4768;3553708
Taquaritinga;2017;10923;6180;4743;3553708
Taquarituba;2013;4957;2889;2068;3553807
Taquarituba;2014;4864;2772;2092;3553807
Taquarituba;2015;4831;2830;2001;3553807
Taquarituba;2016;4760;2754;2006;3553807
Taquarituba;2017;4764;2740;2024;3553807
Taquarivaí;2013;1499;991;508;3553856
Taquarivaí;2014;1413;922;491;3553856
Taquarivaí;2015;1412;933;479;3553856
Taquarivaí;2016;1261;812;449;3553856
Taquarivaí;2017;1240;801;439;3553856
Tarabai;2013;827;471;356;3553906
Tarabai;2014;879;468;411;3553906
Tarabai;2015;918;511;407;3553906
Tarabai;2016;959;548;411;3553906
Tarabai;2017;963;528;435;3553906
Tarumã;2013;6526;4935;1591;3553955
Tarumã;2014;6077;4444;1633;3553955
Tarumã;2015;5467;3867;1600;3553955
Tarumã;2016;5279;3764;1515;3553955
Tarumã;2017;5530;3924;1606;3553955
Tatuí;2013;32191;19178;13013;3554003
Tatuí;2014;31041;18351;12690;3554003
Tatuí;2015;30074;17735;12339;3554003
Tatuí;2016;28719;16716;12003;3554003
Tatuí;2017;28446;16503;11943;3554003
Taubaté;2013;88504;53016;35488;3554102
Taubaté;2014;84964;48868;36096;3554102
Taubaté;2015;82146;47183;34963;3554102
Taubaté;2016;78419;44349;34070;3554102
Taubaté;2017;79269;45592;33677;3554102
Tejupá;2013;710;412;298;3554201
Tejupá;2014;760;440;320;3554201
Tejupá;2015;819;479;340;3554201
Tejupá;2016;803;498;305;3554201
Tejupá;2017;857;502;355;3554201
Teodoro Sampaio;2013;4703;3077;1626;3554300
Teodoro Sampaio;2014;4162;2519;1643;3554300
Teodoro Sampaio;2015;3841;2246;1595;3554300
Teodoro Sampaio;2016;3338;1839;1499;3554300
Teodoro Sampaio;2017;3245;1738;1507;3554300
Terra Roxa;2013;1165;563;602;3554409
Terra Roxa;2014;1076;521;555;3554409
Terra Roxa;2015;1153;569;584;3554409
Terra Roxa;2016;1185;582;603;3554409
Terra Roxa;2017;1196;587;609;3554409
Tietê;2013;14421;8775;5646;3554508
Tietê;2014;14942;9131;5811;3554508
Tietê;2015;14527;8822;5705;3554508
Tietê;2016;14122;8493;5629;3554508
Tietê;2017;14090;8353;5737;3554508
Timburi;2013;405;273;132;3554607
Timburi;2014;378;243;135;3554607
Timburi;2015;389;262;127;3554607
Timburi;2016;391;268;123;3554607
Timburi;2017;399;263;136;3554607
Torre de Pedra;2013;232;118;114;3554656
Torre de Pedra;2014;238;121;117;3554656
Torre de Pedra;2015;250;124;126;3554656
Torre de Pedra;2016;242;124;118;3554656
Torre de Pedra;2017;247;126;121;3554656
Torrinha;2013;1913;1179;734;3554706
Torrinha;2014;2006;1240;766;3554706
Torrinha;2015;2078;1318;760;3554706
Torrinha;2016;1969;1250;719;3554706
Torrinha;2017;2097;1359;738;3554706
Trabiju;2013;361;196;165;3554755
Trabiju;2014;447;211;236;3554755
Trabiju;2015;425;215;210;3554755
Trabiju;2016;418;220;198;3554755
Trabiju;2017;402;231;171;3554755
Tremembé;2013;4769;2763;2006;3554805
Tremembé;2014;4679;2805;1874;3554805
Tremembé;2015;4475;2680;1795;3554805
Tremembé;2016;4300;2476;1824;3554805
Tremembé;2017;4576;2545;2031;3554805
Três Fronteiras;2013;612;378;234;3554904
Três Fronteiras;2014;592;367;225;3554904
Três Fronteiras;2015;637;407;230;3554904
Três Fronteiras;2016;707;452;255;3554904
Três Fronteiras;2017;655;425;230;3554904
Tuiuti;2013;641;403;238;3554953
Tuiuti;2014;602;349;253;3554953
Tuiuti;2015;649;376;273;3554953
Tuiuti;2016;657;371;286;3554953
Tuiuti;2017;680;385;295;3554953
Tupã;2013;16176;8821;7355;3555000
Tupã;2014;16869;9137;7732;3555000
Tupã;2015;16449;8913;7536;3555000
Tupã;2016;15940;8509;7431;3555000
Tupã;2017;16282;8759;7523;3555000
Tupi Paulista;2013;2337;1202;1135;3555109
Tupi Paulista;2014;2373;1176;1197;3555109
Tupi Paulista;2015;2436;1264;1172;3555109
Tupi Paulista;2016;2204;1134;1070;3555109
Tupi Paulista;2017;2252;1145;1107;3555109
Turiúba;2013;349;160;189;3555208
Turiúba;2014;351;168;183;3555208
Turiúba;2015;338;162;176;3555208
Turiúba;2016;309;146;163;3555208
Turiúba;2017;290;146;144;3555208
Turmalina;2013;365;185;180;3555307
Turmalina;2014;375;202;173;3555307
Turmalina;2015;353;186;167;3555307
Turmalina;2016;331;180;151;3555307
Turmalina;2017;325;180;145;3555307
Ubarana;2013;1535;1151;384;3555356
Ubarana;2014;1511;1144;367;3555356
Ubarana;2015;1486;1135;351;3555356
Ubarana;2016;1435;1055;380;3555356
Ubarana;2017;1420;1042;378;3555356
Ubatuba;2013;16219;8762;7457;3555406
Ubatuba;2014;17104;9155;7949;3555406
Ubatuba;2015;18020;9766;8254;3555406
Ubatuba;2016;18375;9991;8384;3555406
Ubatuba;2017;18470;10036;8434;3555406
Ubirajara;2013;932;565;367;3555505
Ubirajara;2014;971;574;397;3555505
Ubirajara;2015;996;584;412;3555505
Ubirajara;2016;1010;626;384;3555505
Ubirajara;2017;1120;707;413;3555505
Uchoa;2013;1379;840;539;3555604
Uchoa;2014;1301;701;600;3555604
Uchoa;2015;1163;630;533;3555604
Uchoa;2016;1232;604;628;3555604
Uchoa;2017;1459;807;652;3555604
União Paulista;2013;263;152;111;3555703
União Paulista;2014;278;158;120;3555703
União Paulista;2015;266;155;111;3555703
União Paulista;2016;274;144;130;3555703
União Paulista;2017;106;72;34;3555703
Urânia;2013;1355;789;566;3555802
Urânia;2014;1359;756;603;3555802
Urânia;2015;1236;674;562;3555802
Urânia;2016;1170;632;538;3555802
Urânia;2017;1201;657;544;3555802
Uru;2013;282;179;103;3555901
Uru;2014;278;175;103;3555901
Uru;2015;275;174;101;3555901
Uru;2016;299;187;112;3555901
Uru;2017;304;187;117;3555901
Urupês;2013;2683;1348;1335;3556008
Urupês;2014;2725;1349;1376;3556008
Urupês;2015;2596;1342;1254;3556008
Urupês;2016;2366;1226;1140;3556008
Urupês;2017;2505;1279;1226;3556008
Valentim Gentil;2013;3541;2123;1418;3556107
Valentim Gentil;2014;3640;2167;1473;3556107
Valentim Gentil;2015;3861;2600;1261;3556107
Valentim Gentil;2016;3303;2153;1150;3556107
Valentim Gentil;2017;3190;2008;1182;3556107
Valinhos;2013;42746;25330;17416;3556206
Valinhos;2014;43169;25133;18036;3556206
Valinhos;2015;44223;25389;18834;3556206
Valinhos;2016;43690;24520;19170;3556206
Valinhos;2017;45013;24743;20270;3556206
Valparaíso;2013;5637;3818;1819;3556305
Valparaíso;2014;5523;3783;1740;3556305
Valparaíso;2015;5755;4015;1740;3556305
Valparaíso;2016;5318;3676;1642;3556305
Valparaíso;2017;5733;4051;1682;3556305
Vargem;2013;1038;585;453;3556354
Vargem;2014;995;586;409;3556354
Vargem;2015;941;548;393;3556354
Vargem;2016;913;520;393;3556354
Vargem;2017;921;522;399;3556354
Vargem Grande do Sul;2013;8321;5000;3321;3556404
Vargem Grande do Sul;2014;8263;4986;3277;3556404
Vargem Grande do Sul;2015;7692;4584;3108;3556404
Vargem Grande do Sul;2016;7366;4408;2958;3556404
Vargem Grande do Sul;2017;7497;4522;2975;3556404
Vargem Grande Paulista;2013;11427;7176;4251;3556453
Vargem Grande Paulista;2014;11008;6627;4381;3556453
Vargem Grande Paulista;2015;13650;9103;4547;3556453
Vargem Grande Paulista;2016;10743;6423;4320;3556453
Vargem Grande Paulista;2017;11125;6726;4399;3556453
Várzea Paulista;2013;17809;11248;6561;3556503
Várzea Paulista;2014;18151;11315;6836;3556503
Várzea Paulista;2015;17136;10420;6716;3556503
Várzea Paulista;2016;16631;9985;6646;3556503
Várzea Paulista;2017;16851;10158;6693;3556503
Vera Cruz;2013;1254;754;500;3556602
Vera Cruz;2014;1272;758;514;3556602
Vera Cruz;2015;1297;772;525;3556602
Vera Cruz;2016;1213;761;452;3556602
Vera Cruz;2017;1209;728;481;3556602
Vinhedo;2013;37419;20735;16684;3556701
Vinhedo;2014;38950;21966;16984;3556701
Vinhedo;2015;36210;20505;15705;3556701
Vinhedo;2016;35172;20928;14244;3556701
Vinhedo;2017;34648;20824;13824;3556701
Viradouro;2013;3130;1274;1856;3556800
Viradouro;2014;3021;1264;1757;3556800
Viradouro;2015;2767;1197;1570;3556800
Viradouro;2016;2699;1145;1554;3556800
Viradouro;2017;3136;1385;1751;3556800
Vista Alegre do Alto;2013;3528;2692;836;3556909
Vista Alegre do Alto;2014;1773;1055;718;3556909
Vista Alegre do Alto;2015;3578;2721;857;3556909
Vista Alegre do Alto;2016;3344;2585;759;3556909
Vista Alegre do Alto;2017;3382;2574;808;3556909
Vitória Brasil;2013;186;96;90;3556958
Vitória Brasil;2014;238;137;101;3556958
Vitória Brasil;2015;217;124;93;3556958
Vitória Brasil;2016;222;127;95;3556958
Vitória Brasil;2017;206;116;90;3556958
Votorantim;2013;19335;10850;8485;3557006
Votorantim;2014;19244;10724;8520;3557006
Votorantim;2015;19468;10681;8787;3557006
Votorantim;2016;18531;10003;8528;3557006
Votorantim;2017;18485;9894;8591;3557006
Votuporanga;2013;25048;13136;11912;3557105
Votuporanga;2014;25647;13538;12109;3557105
Votuporanga;2015;24765;13160;11605;3557105
Votuporanga;2016;23958;12725;11233;3557105
Votuporanga;2017;26835;14325;12510;3557105
Zacarias;2013;656;407;249;3557154
Zacarias;2014;594;385;209;3557154
Zacarias;2015;601;390;211;3557154
Zacarias;2016;576;388;188;3557154
Zacarias;2017;596;400;196;3557154
